CD_MUN,nm_municipio,sg_uf,nm_regiao,qt_votos_validos,qt_votos_bolsonaro,qt_votos_lula
1100015,ALTA FLORESTA D'OESTE,RO,NORTE,13727,9768,3959
1100023,ARIQUEMES,RO,NORTE,50414,39901,10513
1100031,CABIXI,RO,NORTE,3511,2405,1106
1100049,CACOAL,RO,NORTE,50417,37980,12437
1100056,CEREJEIRAS,RO,NORTE,9844,7854,1990
1100064,COLORADO DO OESTE,RO,NORTE,9859,7253,2606
1100072,CORUMBIARA,RO,NORTE,4207,2683,1524
1100080,COSTA MARQUES,RO,NORTE,6645,4220,2425
1100098,ESPIGÃO D'OESTE,RO,NORTE,17807,13595,4212
1100106,GUAJARÁ-MIRIM,RO,NORTE,19839,13001,6838
1100114,JARU,RO,NORTE,29424,22611,6813
1100122,JI-PARANÁ,RO,NORTE,68126,51415,16711
1100130,MACHADINHO D'OESTE,RO,NORTE,16240,11490,4750
1100148,NOVA BRASILÂNDIA D'OESTE,RO,NORTE,10311,7457,2854
1100155,OURO PRETO DO OESTE,RO,NORTE,20503,14631,5872
1100189,PIMENTA BUENO,RO,NORTE,19859,14932,4927
1100205,PORTO VELHO,RO,NORTE,261935,169299,92636
1100254,PRESIDENTE MÉDICI,RO,NORTE,11261,8252,3009
1100262,RIO CRESPO,RO,NORTE,2342,1752,590
1100288,ROLIM DE MOURA,RO,NORTE,29537,21868,7669
1100296,SANTA LUZIA D'OESTE,RO,NORTE,4836,3184,1652
1100304,VILHENA,RO,NORTE,48712,37718,10994
1100320,SÃO MIGUEL DO GUAPORÉ,RO,NORTE,12562,8564,3998
1100338,NOVA MAMORÉ,RO,NORTE,13123,10226,2897
1100346,ALVORADA D'OESTE,RO,NORTE,8239,5306,2933
1100379,ALTO ALEGRE DOS PARECIS,RO,NORTE,6226,4237,1989
1100403,ALTO PARAÍSO,RO,NORTE,8405,6410,1995
1100452,BURITIS,RO,NORTE,15739,12479,3260
1100502,NOVO HORIZONTE DO OESTE,RO,NORTE,5271,3422,1849
1100601,CACAULÂNDIA,RO,NORTE,2902,2210,692
1100700,CAMPO NOVO DE RONDÔNIA,RO,NORTE,5403,3904,1499
1100809,CANDEIAS DO JAMARI,RO,NORTE,12988,8101,4887
1100908,CASTANHEIRAS,RO,NORTE,2218,1356,862
1100924,CHUPINGUAIA,RO,NORTE,4938,3352,1586
1100940,CUJUBIM,RO,NORTE,7547,5818,1729
1101005,GOVERNADOR JORGE TEIXEIRA,RO,NORTE,5165,3625,1540
1101104,ITAPUÃ DO OESTE,RO,NORTE,4378,2736,1642
1101203,MINISTRO ANDREAZZA,RO,NORTE,4542,2973,1569
1101302,MIRANTE DA SERRA,RO,NORTE,6339,3986,2353
1101401,MONTE NEGRO,RO,NORTE,7071,5308,1763
1101435,NOVA UNIÃO,RO,NORTE,4039,2285,1754
1101450,PARECIS,RO,NORTE,2309,1405,904
1101468,PIMENTEIRAS DO OESTE,RO,NORTE,1438,943,495
1101476,PRIMAVERA DE RONDÔNIA,RO,NORTE,2189,1630,559
1101484,SÃO FELIPE D'OESTE,RO,NORTE,3368,2293,1075
1101492,SÃO FRANCISCO DO GUAPORÉ,RO,NORTE,9104,6530,2574
1101500,SERINGUEIRAS,RO,NORTE,7191,4723,2468
1101559,TEIXEIRÓPOLIS,RO,NORTE,2988,1888,1100
1101609,THEOBROMA,RO,NORTE,5600,3816,1784
1101708,URUPÁ,RO,NORTE,6624,4402,2222
1101757,VALE DO ANARI,RO,NORTE,4543,3231,1312
1101807,VALE DO PARAÍSO,RO,NORTE,4335,2808,1527
1200013,ACRELÂNDIA,AC,NORTE,6777,5317,1460
1200054,ASSIS BRASIL,AC,NORTE,4612,2717,1895
1200104,BRASILÉIA,AC,NORTE,13551,9593,3958
1200138,BUJARI,AC,NORTE,6651,4693,1958
1200179,CAPIXABA,AC,NORTE,5460,3963,1497
1200203,CRUZEIRO DO SUL,AC,NORTE,41669,31936,9733
1200252,EPITACIOLÂNDIA,AC,NORTE,9193,6729,2464
1200302,FEIJÓ,AC,NORTE,13496,6383,7113
1200328,JORDÃO,AC,NORTE,3413,1433,1980
1200336,MÂNCIO LIMA,AC,NORTE,9039,6331,2708
1200344,MANOEL URBANO,AC,NORTE,4936,2889,2047
1200351,MARECHAL THAUMATURGO,AC,NORTE,6452,3710,2742
1200385,PLÁCIDO DE CASTRO,AC,NORTE,8482,6176,2306
1200393,PORTO WALTER,AC,NORTE,3959,1866,2093
1200401,RIO BRANCO,AC,NORTE,195963,142090,53873
1200427,RODRIGUES ALVES,AC,NORTE,7466,6011,1455
1200435,SANTA ROSA DO PURUS,AC,NORTE,2344,1127,1217
1200450,SENADOR GUIOMARD,AC,NORTE,12850,9512,3338
1200500,SENA MADUREIRA,AC,NORTE,18582,13606,4976
1200609,TARAUACÁ,AC,NORTE,15869,9067,6802
1200708,XAPURI,AC,NORTE,8851,5217,3634
1200807,PORTO ACRE,AC,NORTE,9701,7384,2317
1300029,ALVARÃES,AM,NORTE,8080,2102,5978
1300060,AMATURÁ,AM,NORTE,5062,1182,3880
1300086,ANAMÃ,AM,NORTE,5784,2051,3733
1300102,ANORI,AM,NORTE,7046,3036,4010
1300144,APUÍ,AM,NORTE,7733,4924,2809
1300201,ATALAIA DO NORTE,AM,NORTE,5796,1136,4660
1300300,AUTAZES,AM,NORTE,19089,6806,12283
1300409,BARCELOS,AM,NORTE,7099,2483,4616
1300508,BARREIRINHA,AM,NORTE,15406,1327,14079
1300607,BENJAMIN CONSTANT,AM,NORTE,15993,2623,13370
1300631,BERURI,AM,NORTE,8539,3158,5381
1300680,BOA VISTA DO RAMOS,AM,NORTE,8909,1072,7837
1300706,BOCA DO ACRE,AM,NORTE,15549,8499,7050
1300805,BORBA,AM,NORTE,15652,3281,12371
1300839,CAAPIRANGA,AM,NORTE,5968,1980,3988
1300904,CANUTAMA,AM,NORTE,6490,2951,3539
1301001,CARAUARI,AM,NORTE,13934,2936,10998
1301100,CAREIRO,AM,NORTE,15519,5570,9949
1301159,CAREIRO DA VÁRZEA,AM,NORTE,11165,4183,6982
1301209,COARI,AM,NORTE,32670,12829,19841
1301308,CODAJÁS,AM,NORTE,10609,4206,6403
1301407,EIRUNEPÉ,AM,NORTE,14088,3653,10435
1301506,ENVIRA,AM,NORTE,7035,1971,5064
1301605,FONTE BOA,AM,NORTE,10901,2480,8421
1301654,GUAJARÁ,AM,NORTE,7298,4407,2891
1301704,HUMAITÁ,AM,NORTE,23341,10935,12406
1301803,IPIXUNA,AM,NORTE,7097,2264,4833
1301852,IRANDUBA,AM,NORTE,27894,12590,15304
1301902,ITACOATIARA,AM,NORTE,49428,17807,31621
1301951,ITAMARATI,AM,NORTE,4784,1106,3678
1302009,ITAPIRANGA,AM,NORTE,5995,2457,3538
1302108,JAPURÁ,AM,NORTE,2902,1128,1774
1302207,JURUÁ,AM,NORTE,4671,1801,2870
1302306,JUTAÍ,AM,NORTE,9094,2222,6872
1302405,LÁBREA,AM,NORTE,17925,6242,11683
1302504,MANACAPURU,AM,NORTE,52053,23667,28386
1302553,MANAQUIRI,AM,NORTE,9468,2906,6562
1302603,MANAUS,AM,NORTE,1130271,692580,437691
1302702,MANICORÉ,AM,NORTE,23228,8056,15172
1302801,MARAÃ,AM,NORTE,5218,1433,3785
1302900,MAUÉS,AM,NORTE,24704,3701,21003
1303007,NHAMUNDÁ,AM,NORTE,10396,1457,8939
1303106,NOVA OLINDA DO NORTE,AM,NORTE,12787,2673,10114
1303205,NOVO AIRÃO,AM,NORTE,7893,3727,4166
1303304,NOVO ARIPUANÃ,AM,NORTE,8852,2105,6747
1303403,PARINTINS,AM,NORTE,50498,8809,41689
1303502,PAUINI,AM,NORTE,7075,2237,4838
1303536,PRESIDENTE FIGUEIREDO,AM,NORTE,16973,7935,9038
1303569,RIO PRETO DA EVA,AM,NORTE,12833,6081,6752
1303601,SANTA ISABEL DO RIO NEGRO,AM,NORTE,5008,1305,3703
1303700,SANTO ANTÔNIO DO IÇÁ,AM,NORTE,11999,3150,8849
1303809,SÃO GABRIEL DA CACHOEIRA,AM,NORTE,21193,4103,17090
1303908,SÃO PAULO DE OLIVENÇA,AM,NORTE,14153,2231,11922
1303957,SÃO SEBASTIÃO DO UATUMÃ,AM,NORTE,4825,2279,2546
1304005,SILVES,AM,NORTE,5852,1081,4771
1304062,TABATINGA,AM,NORTE,25950,8582,17368
1304104,TAPAUÁ,AM,NORTE,8615,3967,4648
1304203,TEFÉ,AM,NORTE,31581,11300,20281
1304237,TONANTINS,AM,NORTE,7605,1298,6307
1304260,UARINI,AM,NORTE,6023,1936,4087
1304302,URUCARÁ,AM,NORTE,8225,1908,6317
1304401,URUCURITUBA,AM,NORTE,8909,1836,7073
1400027,AMAJARI,RR,NORTE,4676,3610,1066
1400050,ALTO ALEGRE,RR,NORTE,8153,6030,2123
1400100,BOA VISTA,RR,NORTE,182211,144799,37412
1400159,BONFIM,RR,NORTE,7581,5199,2382
1400175,CANTÁ,RR,NORTE,9767,7107,2660
1400209,CARACARAÍ,RR,NORTE,9806,7077,2729
1400233,CAROEBE,RR,NORTE,5154,4135,1019
1400282,IRACEMA,RR,NORTE,4238,2980,1258
1400308,MUCAJAÍ,RR,NORTE,9403,7412,1991
1400407,NORMANDIA,RR,NORTE,6043,3517,2526
1400456,PACARAIMA,RR,NORTE,6003,3838,2165
1400472,RORAINÓPOLIS,RR,NORTE,14789,10843,3946
1400506,SÃO JOÃO DA BALIZA,RR,NORTE,3694,2471,1223
1400605,SÃO LUIZ,RR,NORTE,3952,2854,1098
1400704,UIRAMUTÃ,RR,NORTE,5176,1646,3530
1500107,ABAETETUBA,PA,NORTE,97431,25118,72313
1500131,ABEL FIGUEIREDO,PA,NORTE,4125,1768,2357
1500206,ACARÁ,PA,NORTE,35694,11026,24668
1500305,AFUÁ,PA,NORTE,18911,6268,12643
1500347,ÁGUA AZUL DO NORTE,PA,NORTE,7546,4424,3122
1500404,ALENQUER,PA,NORTE,31583,15563,16020
1500503,ALMEIRIM,PA,NORTE,16306,4855,11451
1500602,ALTAMIRA,PA,NORTE,63565,39713,23852
1500701,ANAJÁS,PA,NORTE,14169,6968,7201
1500800,ANANINDEUA,PA,NORTE,276384,138978,137406
1500859,ANAPU,PA,NORTE,15710,9673,6037
1500909,AUGUSTO CORRÊA,PA,NORTE,26364,7086,19278
1500958,AURORA DO PARÁ,PA,NORTE,13411,3845,9566
1501006,AVEIRO,PA,NORTE,7465,2990,4475
1501105,BAGRE,PA,NORTE,10377,2206,8171
1501204,BAIÃO,PA,NORTE,19741,4983,14758
1501253,BANNACH,PA,NORTE,2130,1340,790
1501303,BARCARENA,PA,NORTE,74642,26380,48262
1501402,BELÉM,PA,NORTE,858909,431858,427051
1501451,BELTERRA,PA,NORTE,11686,5618,6068
1501501,BENEVIDES,PA,NORTE,36592,16723,19869
1501576,BOM JESUS DO TOCANTINS,PA,NORTE,8342,3763,4579
1501600,BONITO,PA,NORTE,9488,2761,6727
1501709,BRAGANÇA,PA,NORTE,66261,24883,41378
1501725,BRASIL NOVO,PA,NORTE,12197,8088,4109
1501758,BREJO GRANDE DO ARAGUAIA,PA,NORTE,4941,2130,2811
1501782,BREU BRANCO,PA,NORTE,21664,9276,12388
1501808,BREVES,PA,NORTE,48992,18062,30930
1501907,BUJARU,PA,NORTE,17097,5085,12012
1501956,CACHOEIRA DO PIRIÁ,PA,NORTE,9963,2634,7329
1502004,CACHOEIRA DO ARARI,PA,NORTE,13407,2750,10657
1502103,CAMETÁ,PA,NORTE,80218,19273,60945
1502152,CANAÃ DOS CARAJÁS,PA,NORTE,36214,22799,13415
1502202,CAPANEMA,PA,NORTE,41201,16458,24743
1502301,CAPITÃO POÇO,PA,NORTE,32407,11640,20767
1502400,CASTANHAL,PA,NORTE,111906,58469,53437
1502509,CHAVES,PA,NORTE,9094,2977,6117
1502608,COLARES,PA,NORTE,8247,2028,6219
1502707,CONCEIÇÃO DO ARAGUAIA,PA,NORTE,24091,13451,10640
1502756,CONCÓRDIA DO PARÁ,PA,NORTE,18297,6738,11559
1502764,CUMARU DO NORTE,PA,NORTE,5153,3217,1936
1502772,CURIONÓPOLIS,PA,NORTE,12343,6524,5819
1502806,CURRALINHO,PA,NORTE,17231,3766,13465
1502855,CURUÁ,PA,NORTE,8308,1911,6397
1502905,CURUÇÁ,PA,NORTE,24486,6688,17798
1502939,DOM ELISEU,PA,NORTE,22581,10883,11698
1502954,ELDORADO DOS CARAJÁS,PA,NORTE,14511,7326,7185
1503002,FARO,PA,NORTE,4714,942,3772
1503044,FLORESTA DO ARAGUAIA,PA,NORTE,10337,5535,4802
1503077,GARRAFÃO DO NORTE,PA,NORTE,16254,4355,11899
1503093,GOIANÉSIA DO PARÁ,PA,NORTE,15230,6556,8674
1503101,GURUPÁ,PA,NORTE,16081,4565,11516
1503200,IGARAPÉ-AÇU,PA,NORTE,24265,6676,17589
1503309,IGARAPÉ-MIRI,PA,NORTE,39089,14004,25085
1503408,INHANGAPI,PA,NORTE,7288,2704,4584
1503457,IPIXUNA DO PARÁ,PA,NORTE,16899,5772,11127
1503507,IRITUIA,PA,NORTE,19895,5029,14866
1503606,ITAITUBA,PA,NORTE,57322,35796,21526
1503705,ITUPIRANGA,PA,NORTE,22962,9058,13904
1503754,JACAREACANGA,PA,NORTE,8485,3982,4503
1503804,JACUNDÁ,PA,NORTE,23629,10431,13198
1503903,JURUTI,PA,NORTE,28085,11557,16528
1504000,LIMOEIRO DO AJURU,PA,NORTE,17223,4613,12610
1504059,MÃE DO RIO,PA,NORTE,18799,8584,10215
1504109,MAGALHÃES BARATA,PA,NORTE,5996,1803,4193
1504208,MARABÁ,PA,NORTE,138893,74985,63908
1504307,MARACANÃ,PA,NORTE,19139,5961,13178
1504406,MARAPANIM,PA,NORTE,17288,5642,11646
1504422,MARITUBA,PA,NORTE,66953,30886,36067
1504455,MEDICILÂNDIA,PA,NORTE,15007,10099,4908
1504505,MELGAÇO,PA,NORTE,11165,3603,7562
1504604,MOCAJUBA,PA,NORTE,20771,5320,15451
1504703,MOJU,PA,NORTE,42206,11761,30445
1504752,MOJUÍ DOS CAMPOS,PA,NORTE,15503,9152,6351
1504802,MONTE ALEGRE,PA,NORTE,37660,19420,18240
1504901,MUANÁ,PA,NORTE,20679,4999,15680
1504950,NOVA ESPERANÇA DO PIRIÁ,PA,NORTE,11562,4902,6660
1504976,NOVA IPIXUNA,PA,NORTE,7817,3644,4173
1505007,NOVA TIMBOTEUA,PA,NORTE,8817,2388,6429
1505031,NOVO PROGRESSO,PA,NORTE,16614,13776,2838
1505064,NOVO REPARTIMENTO,PA,NORTE,32116,18037,14079
1505106,ÓBIDOS,PA,NORTE,28453,8577,19876
1505205,OEIRAS DO PARÁ,PA,NORTE,18105,3587,14518
1505304,ORIXIMINÁ,PA,NORTE,33533,14432,19101
1505403,OURÉM,PA,NORTE,12162,3112,9050
1505437,OURILÂNDIA DO NORTE,PA,NORTE,16579,10144,6435
1505486,PACAJÁ,PA,NORTE,20151,12112,8039
1505494,PALESTINA DO PARÁ,PA,NORTE,4354,1774,2580
1505502,PARAGOMINAS,PA,NORTE,54348,32193,22155
1505536,PARAUAPEBAS,PA,NORTE,140199,83810,56389
1505551,PAU D'ARCO,PA,NORTE,5218,2849,2369
1505601,PEIXE-BOI,PA,NORTE,6620,1940,4680
1505635,PIÇARRA,PA,NORTE,6817,3609,3208
1505650,PLACAS,PA,NORTE,10173,6541,3632
1505700,PONTA DE PEDRAS,PA,NORTE,16269,4140,12129
1505809,PORTEL,PA,NORTE,24705,8354,16351
1505908,PORTO DE MOZ,PA,NORTE,15877,5928,9949
1506005,PRAINHA,PA,NORTE,19360,8220,11140
1506104,PRIMAVERA,PA,NORTE,7840,1935,5905
1506112,QUATIPURU,PA,NORTE,6962,1702,5260
1506138,REDENÇÃO,PA,NORTE,47359,32790,14569
1506161,RIO MARIA,PA,NORTE,10391,6088,4303
1506187,RONDON DO PARÁ,PA,NORTE,20248,10818,9430
1506195,RURÓPOLIS,PA,NORTE,13923,8443,5480
1506203,SALINÓPOLIS,PA,NORTE,26189,9136,17053
1506302,SALVATERRA,PA,NORTE,14636,4183,10453
1506351,SANTA BÁRBARA DO PARÁ,PA,NORTE,13157,5668,7489
1506401,SANTA CRUZ DO ARARI,PA,NORTE,4240,1177,3063
1506500,SANTA ISABEL DO PARÁ,PA,NORTE,37918,17392,20526
1506559,SANTA LUZIA DO PARÁ,PA,NORTE,12890,3385,9505
1506583,SANTA MARIA DAS BARREIRAS,PA,NORTE,8921,5548,3373
1506609,SANTA MARIA DO PARÁ,PA,NORTE,16798,7328,9470
1506708,SANTANA DO ARAGUAIA,PA,NORTE,16640,10661,5979
1506807,SANTARÉM,PA,NORTE,184638,102608,82030
1506906,SANTARÉM NOVO,PA,NORTE,4837,1206,3631
1507003,SANTO ANTÔNIO DO TAUÁ,PA,NORTE,19205,6968,12237
1507102,SÃO CAETANO DE ODIVELAS,PA,NORTE,11262,2879,8383
1507151,SÃO DOMINGOS DO ARAGUAIA,PA,NORTE,11805,5044,6761
1507201,SÃO DOMINGOS DO CAPIM,PA,NORTE,18060,4463,13597
1507300,SÃO FÉLIX DO XINGU,PA,NORTE,29360,19548,9812
1507409,SÃO FRANCISCO DO PARÁ,PA,NORTE,12160,4491,7669
1507458,SÃO GERALDO DO ARAGUAIA,PA,NORTE,14368,8116,6252
1507466,SÃO JOÃO DA PONTA,PA,NORTE,4471,1349,3122
1507474,SÃO JOÃO DE PIRABAS,PA,NORTE,12520,3700,8820
1507508,SÃO JOÃO DO ARAGUAIA,PA,NORTE,8230,3268,4962
1507607,SÃO MIGUEL DO GUAMÁ,PA,NORTE,31545,10074,21471
1507706,SÃO SEBASTIÃO DA BOA VISTA,PA,NORTE,16446,3965,12481
1507755,SAPUCAIA,PA,NORTE,3460,1691,1769
1507805,SENADOR JOSÉ PORFÍRIO,PA,NORTE,9040,4306,4734
1507904,SOURE,PA,NORTE,15590,3667,11923
1507953,TAILÂNDIA,PA,NORTE,38875,18071,20804
1507961,TERRA ALTA,PA,NORTE,8104,2762,5342
1507979,TERRA SANTA,PA,NORTE,10486,4362,6124
1508001,TOMÉ-AÇU,PA,NORTE,37947,14937,23010
1508035,TRACUATEUA,PA,NORTE,18325,3924,14401
1508050,TRAIRÃO,PA,NORTE,8140,5541,2599
1508084,TUCUMÃ,PA,NORTE,19946,13145,6801
1508100,TUCURUÍ,PA,NORTE,52701,22909,29792
1508126,ULIANÓPOLIS,PA,NORTE,14372,7150,7222
1508159,URUARÁ,PA,NORTE,22227,16301,5926
1508209,VIGIA,PA,NORTE,28690,8675,20015
1508308,VISEU,PA,NORTE,31654,6140,25514
1508357,VITÓRIA DO XINGU,PA,NORTE,11034,5734,5300
1508407,XINGUARA,PA,NORTE,26322,16632,9690
1600055,SERRA DO NAVIO,AP,NORTE,2569,1543,1026
1600105,AMAPÁ,AP,NORTE,4448,1663,2785
1600154,PEDRA BRANCA DO AMAPARI,AP,NORTE,6446,2856,3590
1600204,CALÇOENE,AP,NORTE,5186,1986,3200
1600212,CUTIAS,AP,NORTE,3092,1248,1844
1600238,FERREIRA GOMES,AP,NORTE,4015,1862,2153
1600253,ITAUBAL,AP,NORTE,4413,2047,2366
1600279,LARANJAL DO JARI,AP,NORTE,18518,7296,11222
1600303,MACAPÁ,AP,NORTE,228071,125261,102810
1600402,MAZAGÃO,AP,NORTE,13433,4967,8466
1600501,OIAPOQUE,AP,NORTE,12594,4444,8150
1600535,PORTO GRANDE,AP,NORTE,9232,4112,5120
1600550,PRACUÚBA,AP,NORTE,2338,1069,1269
1600600,SANTANA,AP,NORTE,63090,35397,27693
1600709,TARTARUGALZINHO,AP,NORTE,6520,2756,3764
1600808,VITÓRIA DO JARI,AP,NORTE,6500,2040,4460
1700251,ABREULÂNDIA,TO,NORTE,1781,749,1032
1700301,AGUIARNÓPOLIS,TO,NORTE,2899,1039,1860
1700350,ALIANÇA DO TOCANTINS,TO,NORTE,3131,1446,1685
1700400,ALMAS,TO,NORTE,3782,1248,2534
1700707,ALVORADA,TO,NORTE,5403,2965,2438
1701002,ANANÁS,TO,NORTE,5369,2145,3224
1701051,ANGICO,TO,NORTE,1909,785,1124
1701101,APARECIDA DO RIO NEGRO,TO,NORTE,3212,1437,1775
1701309,ARAGOMINAS,TO,NORTE,3397,1277,2120
1701903,ARAGUACEMA,TO,NORTE,3489,1359,2130
1702000,ARAGUAÇU,TO,NORTE,4887,3441,1446
1702109,ARAGUAÍNA,TO,NORTE,89995,52404,37591
1702158,ARAGUANÃ,TO,NORTE,2669,1328,1341
1702208,ARAGUATINS,TO,NORTE,16003,6541,9462
1702307,ARAPOEMA,TO,NORTE,3458,1503,1955
1702406,ARRAIAS,TO,NORTE,5702,1461,4241
1702554,AUGUSTINÓPOLIS,TO,NORTE,9678,3877,5801
1702703,AURORA DO TOCANTINS,TO,NORTE,2212,773,1439
1702901,AXIXÁ DO TOCANTINS,TO,NORTE,6747,2712,4035
1703008,BABAÇULÂNDIA,TO,NORTE,5004,1600,3404
1703057,BANDEIRANTES DO TOCANTINS,TO,NORTE,2086,1101,985
1703073,BARRA DO OURO,TO,NORTE,2661,951,1710
1703107,BARROLÂNDIA,TO,NORTE,3567,1737,1830
1703206,BERNARDO SAYÃO,TO,NORTE,2628,1401,1227
1703305,BOM JESUS DO TOCANTINS,TO,NORTE,2530,1137,1393
1703602,BRASILÂNDIA DO TOCANTINS,TO,NORTE,1395,602,793
1703701,BREJINHO DE NAZARÉ,TO,NORTE,3013,1331,1682
1703800,BURITI DO TOCANTINS,TO,NORTE,4978,1980,2998
1703826,CACHOEIRINHA,TO,NORTE,1309,849,460
1703842,CAMPOS LINDOS,TO,NORTE,4740,1739,3001
1703867,CARIRI DO TOCANTINS,TO,NORTE,2698,1338,1360
1703883,CARMOLÂNDIA,TO,NORTE,1791,693,1098
1703891,CARRASCO BONITO,TO,NORTE,2191,715,1476
1703909,CASEARA,TO,NORTE,2897,1140,1757
1704105,CENTENÁRIO,TO,NORTE,1387,429,958
1704600,CHAPADA DE AREIA,TO,NORTE,1661,849,812
1705102,CHAPADA DA NATIVIDADE,TO,NORTE,2059,489,1570
1705508,COLINAS DO TOCANTINS,TO,NORTE,17851,10361,7490
1705557,COMBINADO,TO,NORTE,2869,1389,1480
1705607,CONCEIÇÃO DO TOCANTINS,TO,NORTE,2275,551,1724
1706001,COUTO MAGALHÃES,TO,NORTE,3289,1235,2054
1706100,CRISTALÂNDIA,TO,NORTE,4078,1865,2213
1706258,CRIXÁS DO TOCANTINS,TO,NORTE,1271,601,670
1706506,DARCINÓPOLIS,TO,NORTE,3090,1130,1960
1707009,DIANÓPOLIS,TO,NORTE,9571,3431,6140
1707108,DIVINÓPOLIS DO TOCANTINS,TO,NORTE,4147,1629,2518
1707207,DOIS IRMÃOS DO TOCANTINS,TO,NORTE,3686,1267,2419
1707306,DUERÉ,TO,NORTE,2576,1003,1573
1707405,ESPERANTINA,TO,NORTE,4469,1257,3212
1707553,FÁTIMA,TO,NORTE,2473,1288,1185
1707652,FIGUEIRÓPOLIS,TO,NORTE,3441,1759,1682
1707702,FILADÉLFIA,TO,NORTE,4641,1732,2909
1708205,FORMOSO DO ARAGUAIA,TO,NORTE,10445,5747,4698
1708254,TABOCÃO,TO,NORTE,2324,1066,1258
1708304,GOIANORTE,TO,NORTE,3337,1589,1748
1709005,GOIATINS,TO,NORTE,6107,1715,4392
1709302,GUARAÍ,TO,NORTE,13174,7124,6050
1709500,GURUPI,TO,NORTE,45004,26670,18334
1709807,IPUEIRAS,TO,NORTE,1303,353,950
1710508,ITACAJÁ,TO,NORTE,4158,1503,2655
1710706,ITAGUATINS,TO,NORTE,3329,1080,2249
1710904,ITAPIRATINS,TO,NORTE,2498,890,1608
1711100,ITAPORÃ DO TOCANTINS,TO,NORTE,1795,816,979
1711506,JAÚ DO TOCANTINS,TO,NORTE,2111,968,1143
1711803,JUARINA,TO,NORTE,1580,703,877
1711902,LAGOA DA CONFUSÃO,TO,NORTE,6575,3308,3267
1711951,LAGOA DO TOCANTINS,TO,NORTE,2286,749,1537
1712009,LAJEADO,TO,NORTE,2423,1165,1258
1712157,LAVANDEIRA,TO,NORTE,1292,459,833
1712405,LIZARDA,TO,NORTE,1915,474,1441
1712454,LUZINÓPOLIS,TO,NORTE,1871,680,1191
1712504,MARIANÓPOLIS DO TOCANTINS,TO,NORTE,2623,1209,1414
1712702,MATEIROS,TO,NORTE,1504,478,1026
1712801,MAURILÂNDIA DO TOCANTINS,TO,NORTE,2434,604,1830
1713205,MIRACEMA DO TOCANTINS,TO,NORTE,10657,4195,6462
1713304,MIRANORTE,TO,NORTE,7535,3754,3781
1713601,MONTE DO CARMO,TO,NORTE,3480,1287,2193
1713700,MONTE SANTO DO TOCANTINS,TO,NORTE,1856,1055,801
1713809,PALMEIRAS DO TOCANTINS,TO,NORTE,3076,1156,1920
1713957,MURICILÂNDIA,TO,NORTE,2047,752,1295
1714203,NATIVIDADE,TO,NORTE,4793,1865,2928
1714302,NAZARÉ,TO,NORTE,3075,827,2248
1714880,NOVA OLINDA,TO,NORTE,6188,2832,3356
1715002,NOVA ROSALÂNDIA,TO,NORTE,2126,1174,952
1715101,NOVO ACORDO,TO,NORTE,2848,1222,1626
1715150,NOVO ALEGRE,TO,NORTE,1466,529,937
1715259,NOVO JARDIM,TO,NORTE,1578,465,1113
1715507,OLIVEIRA DE FÁTIMA,TO,NORTE,1151,499,652
1715705,PALMEIRANTE,TO,NORTE,2847,945,1902
1715754,PALMEIRÓPOLIS,TO,NORTE,4352,2394,1958
1716109,PARAÍSO DO TOCANTINS,TO,NORTE,26056,17707,8349
1716208,PARANÃ,TO,NORTE,5585,1136,4449
1716307,PAU D'ARCO,TO,NORTE,2493,1186,1307
1716505,PEDRO AFONSO,TO,NORTE,7565,3732,3833
1716604,PEIXE,TO,NORTE,5218,1764,3454
1716653,PEQUIZEIRO,TO,NORTE,3248,1397,1851
1716703,COLMÉIA,TO,NORTE,4870,2992,1878
1717008,PINDORAMA DO TOCANTINS,TO,NORTE,2707,1074,1633
1717206,PIRAQUÊ,TO,NORTE,1627,653,974
1717503,PIUM,TO,NORTE,4250,2157,2093
1717800,PONTE ALTA DO BOM JESUS,TO,NORTE,2541,769,1772
1717909,PONTE ALTA DO TOCANTINS,TO,NORTE,4007,1916,2091
1718006,PORTO ALEGRE DO TOCANTINS,TO,NORTE,1633,483,1150
1718204,PORTO NACIONAL,TO,NORTE,34053,16152,17901
1718303,PRAIA NORTE,TO,NORTE,4075,1281,2794
1718402,PRESIDENTE KENNEDY,TO,NORTE,2059,926,1133
1718451,PUGMIL,TO,NORTE,1571,834,737
1718501,RECURSOLÂNDIA,TO,NORTE,2164,587,1577
1718550,RIACHINHO,TO,NORTE,2684,1010,1674
1718659,RIO DA CONCEIÇÃO,TO,NORTE,1424,459,965
1718709,RIO DOS BOIS,TO,NORTE,1897,699,1198
1718758,RIO SONO,TO,NORTE,3173,1345,1828
1718808,SAMPAIO,TO,NORTE,2621,788,1833
1718840,SANDOLÂNDIA,TO,NORTE,2544,1322,1222
1718865,SANTA FÉ DO ARAGUAIA,TO,NORTE,3953,1689,2264
1718881,SANTA MARIA DO TOCANTINS,TO,NORTE,1873,838,1035
1718899,SANTA RITA DO TOCANTINS,TO,NORTE,1515,741,774
1718907,SANTA ROSA DO TOCANTINS,TO,NORTE,3074,924,2150
1719004,SANTA TEREZA DO TOCANTINS,TO,NORTE,2280,1110,1170
1720002,SANTA TEREZINHA DO TOCANTINS,TO,NORTE,1578,558,1020
1720101,SÃO BENTO DO TOCANTINS,TO,NORTE,3292,975,2317
1720150,SÃO FÉLIX DO TOCANTINS,TO,NORTE,1101,285,816
1720200,SÃO MIGUEL DO TOCANTINS,TO,NORTE,6301,2227,4074
1720259,SÃO SALVADOR DO TOCANTINS,TO,NORTE,1604,484,1120
1720309,SÃO SEBASTIÃO DO TOCANTINS,TO,NORTE,2441,673,1768
1720499,SÃO VALÉRIO,TO,NORTE,2764,751,2013
1720655,SILVANÓPOLIS,TO,NORTE,3421,1372,2049
1720804,SÍTIO NOVO DO TOCANTINS,TO,NORTE,6034,1896,4138
1720853,SUCUPIRA,TO,NORTE,1273,612,661
1720903,TAGUATINGA,TO,NORTE,7793,2768,5025
1720937,TAIPAS DO TOCANTINS,TO,NORTE,1300,316,984
1720978,TALISMÃ,TO,NORTE,1854,872,982
1721000,PALMAS,TO,NORTE,158676,95715,62961
1721109,TOCANTÍNIA,TO,NORTE,3954,1109,2845
1721208,TOCANTINÓPOLIS,TO,NORTE,12562,4092,8470
1721257,TUPIRAMA,TO,NORTE,1383,568,815
1721307,TUPIRATINS,TO,NORTE,1314,423,891
1722081,WANDERLÂNDIA,TO,NORTE,5184,2055,3129
1722107,XAMBIOÁ,TO,NORTE,6450,3251,3199
2100055,AÇAILÂNDIA,MA,NORDESTE,58780,31734,27046
2100105,AFONSO CUNHA,MA,NORDESTE,5188,548,4640
2100154,ÁGUA DOCE DO MARANHÃO,MA,NORDESTE,7914,1296,6618
2100204,ALCÂNTARA,MA,NORDESTE,12126,2455,9671
2100303,ALDEIAS ALTAS,MA,NORDESTE,13262,2038,11224
2100402,ALTAMIRA DO MARANHÃO,MA,NORDESTE,3797,861,2936
2100436,ALTO ALEGRE DO MARANHÃO,MA,NORDESTE,13392,2721,10671
2100477,ALTO ALEGRE DO PINDARÉ,MA,NORDESTE,14993,2533,12460
2100501,ALTO PARNAÍBA,MA,NORDESTE,5942,1795,4147
2100550,AMAPÁ DO MARANHÃO,MA,NORDESTE,3898,902,2996
2100600,AMARANTE DO MARANHÃO,MA,NORDESTE,19959,8491,11468
2100709,ANAJATUBA,MA,NORDESTE,14193,2252,11941
2100808,ANAPURUS,MA,NORDESTE,10696,2066,8630
2100832,APICUM-AÇU,MA,NORDESTE,9472,2410,7062
2100873,ARAGUANÃ,MA,NORDESTE,5562,1000,4562
2100907,ARAIOSES,MA,NORDESTE,23643,3718,19925
2100956,ARAME,MA,NORDESTE,15878,4361,11517
2101004,ARARI,MA,NORDESTE,17275,3981,13294
2101103,AXIXÁ,MA,NORDESTE,7850,1553,6297
2101202,BACABAL,MA,NORDESTE,51898,17601,34297
2101251,BACABEIRA,MA,NORDESTE,11318,2177,9141
2101301,BACURI,MA,NORDESTE,9492,1411,8081
2101350,BACURITUBA,MA,NORDESTE,3525,383,3142
2101400,BALSAS,MA,NORDESTE,50214,24202,26012
2101509,BARÃO DE GRAJAÚ,MA,NORDESTE,11240,1389,9851
2101608,BARRA DO CORDA,MA,NORDESTE,45047,15143,29904
2101707,BARREIRINHAS,MA,NORDESTE,36211,7080,29131
2101731,BELÁGUA,MA,NORDESTE,5610,507,5103
2101772,BELA VISTA DO MARANHÃO,MA,NORDESTE,7162,1489,5673
2101806,BENEDITO LEITE,MA,NORDESTE,3160,634,2526
2101905,BEQUIMÃO,MA,NORDESTE,13272,2225,11047
2101939,BERNARDO DO MEARIM,MA,NORDESTE,3912,961,2951
2101970,BOA VISTA DO GURUPI,MA,NORDESTE,4392,1097,3295
2102002,BOM JARDIM,MA,NORDESTE,19070,4489,14581
2102036,BOM JESUS DAS SELVAS,MA,NORDESTE,14602,4748,9854
2102077,BOM LUGAR,MA,NORDESTE,8525,1954,6571
2102101,BREJO,MA,NORDESTE,18247,3496,14751
2102150,BREJO DE AREIA,MA,NORDESTE,5420,1258,4162
2102200,BURITI,MA,NORDESTE,15215,1856,13359
2102309,BURITI BRAVO,MA,NORDESTE,12797,1803,10994
2102325,BURITICUPU,MA,NORDESTE,31070,10061,21009
2102358,BURITIRANA,MA,NORDESTE,8618,3290,5328
2102374,CACHOEIRA GRANDE,MA,NORDESTE,5962,1065,4897
2102408,CAJAPIÓ,MA,NORDESTE,6372,651,5721
2102507,CAJARI,MA,NORDESTE,11293,1379,9914
2102556,CAMPESTRE DO MARANHÃO,MA,NORDESTE,7243,2249,4994
2102606,CÂNDIDO MENDES,MA,NORDESTE,10707,2622,8085
2102705,CANTANHEDE,MA,NORDESTE,9651,1603,8048
2102754,CAPINZAL DO NORTE,MA,NORDESTE,6712,1584,5128
2102804,CAROLINA,MA,NORDESTE,13495,4918,8577
2102903,CARUTAPERA,MA,NORDESTE,13102,3494,9608
2103000,CAXIAS,MA,NORDESTE,84470,19276,65194
2103109,CEDRAL,MA,NORDESTE,6249,1149,5100
2103125,CENTRAL DO MARANHÃO,MA,NORDESTE,5084,480,4604
2103158,CENTRO DO GUILHERME,MA,NORDESTE,5576,983,4593
2103174,CENTRO NOVO DO MARANHÃO,MA,NORDESTE,8895,1835,7060
2103208,CHAPADINHA,MA,NORDESTE,42981,11173,31808
2103257,CIDELÂNDIA,MA,NORDESTE,8132,2380,5752
2103307,CODÓ,MA,NORDESTE,56409,13035,43374
2103406,COELHO NETO,MA,NORDESTE,24115,4330,19785
2103505,COLINAS,MA,NORDESTE,20912,4099,16813
2103554,CONCEIÇÃO DO LAGO-AÇU,MA,NORDESTE,8404,1912,6492
2103604,COROATÁ,MA,NORDESTE,32709,8352,24357
2103703,CURURUPU,MA,NORDESTE,18346,3049,15297
2103752,DAVINÓPOLIS,MA,NORDESTE,8718,3158,5560
2103802,DOM PEDRO,MA,NORDESTE,13424,4159,9265
2103901,DUQUE BACELAR,MA,NORDESTE,7048,770,6278
2104008,ESPERANTINÓPOLIS,MA,NORDESTE,10722,2589,8133
2104057,ESTREITO,MA,NORDESTE,17578,7836,9742
2104073,FEIRA NOVA DO MARANHÃO,MA,NORDESTE,4840,1601,3239
2104081,FERNANDO FALCÃO,MA,NORDESTE,7120,1565,5555
2104099,FORMOSA DA SERRA NEGRA,MA,NORDESTE,10133,3724,6409
2104107,FORTALEZA DOS NOGUEIRAS,MA,NORDESTE,7897,2381,5516
2104206,FORTUNA,MA,NORDESTE,9112,1637,7475
2104305,GODOFREDO VIANA,MA,NORDESTE,5712,1634,4078
2104404,GONÇALVES DIAS,MA,NORDESTE,9487,2101,7386
2104503,GOVERNADOR ARCHER,MA,NORDESTE,6008,1077,4931
2104552,GOVERNADOR EDISON LOBÃO,MA,NORDESTE,11138,4219,6919
2104602,GOVERNADOR EUGÊNIO BARROS,MA,NORDESTE,8216,1529,6687
2104628,GOVERNADOR LUIZ ROCHA,MA,NORDESTE,4684,1266,3418
2104651,GOVERNADOR NEWTON BELLO,MA,NORDESTE,5477,1026,4451
2104677,GOVERNADOR NUNES FREIRE,MA,NORDESTE,12355,3709,8646
2104701,GRAÇA ARANHA,MA,NORDESTE,4557,922,3635
2104800,GRAJAÚ,MA,NORDESTE,37208,12787,24421
2104909,GUIMARÃES,MA,NORDESTE,6647,845,5802
2105005,HUMBERTO DE CAMPOS,MA,NORDESTE,15509,2694,12815
2105104,ICATU,MA,NORDESTE,15325,2787,12538
2105153,IGARAPÉ DO MEIO,MA,NORDESTE,8100,1365,6735
2105203,IGARAPÉ GRANDE,MA,NORDESTE,6523,2231,4292
2105302,IMPERATRIZ,MA,NORDESTE,144832,79356,65476
2105351,ITAIPAVA DO GRAJAÚ,MA,NORDESTE,7503,1735,5768
2105401,ITAPECURU MIRIM,MA,NORDESTE,33415,6812,26603
2105427,ITINGA DO MARANHÃO,MA,NORDESTE,13238,6221,7017
2105450,JATOBÁ,MA,NORDESTE,4958,864,4094
2105476,JENIPAPO DOS VIEIRAS,MA,NORDESTE,9487,1911,7576
2105500,JOÃO LISBOA,MA,NORDESTE,16287,5830,10457
2105609,JOSELÂNDIA,MA,NORDESTE,9132,1936,7196
2105658,JUNCO DO MARANHÃO,MA,NORDESTE,3560,681,2879
2105708,LAGO DA PEDRA,MA,NORDESTE,25537,10528,15009
2105807,LAGO DO JUNCO,MA,NORDESTE,6249,1453,4796
2105906,LAGO VERDE,MA,NORDESTE,9049,1515,7534
2105922,LAGOA DO MATO,MA,NORDESTE,6051,799,5252
2105948,LAGO DOS RODRIGUES,MA,NORDESTE,6333,1475,4858
2105963,LAGOA GRANDE DO MARANHÃO,MA,NORDESTE,7241,1516,5725
2105989,LAJEADO NOVO,MA,NORDESTE,4822,1946,2876
2106003,LIMA CAMPOS,MA,NORDESTE,8147,2548,5599
2106102,LORETO,MA,NORDESTE,6299,1408,4891
2106201,LUÍS DOMINGUES,MA,NORDESTE,4170,1311,2859
2106300,MAGALHÃES DE ALMEIDA,MA,NORDESTE,9130,2051,7079
2106326,MARACAÇUMÉ,MA,NORDESTE,10377,3174,7203
2106359,MARAJÁ DO SENA,MA,NORDESTE,4420,977,3443
2106375,MARANHÃOZINHO,MA,NORDESTE,5784,1087,4697
2106409,MATA ROMA,MA,NORDESTE,11593,2172,9421
2106508,MATINHA,MA,NORDESTE,14390,3329,11061
2106607,MATÕES,MA,NORDESTE,18391,2868,15523
2106631,MATÕES DO NORTE,MA,NORDESTE,4814,711,4103
2106672,MILAGRES DO MARANHÃO,MA,NORDESTE,4258,614,3644
2106706,MIRADOR,MA,NORDESTE,11909,2050,9859
2106755,MIRANDA DO NORTE,MA,NORDESTE,11692,2856,8836
2106805,MIRINZAL,MA,NORDESTE,8119,1625,6494
2106904,MONÇÃO,MA,NORDESTE,14086,2612,11474
2107001,MONTES ALTOS,MA,NORDESTE,5790,1956,3834
2107100,MORROS,MA,NORDESTE,11692,2429,9263
2107209,NINA RODRIGUES,MA,NORDESTE,7018,1186,5832
2107258,NOVA COLINAS,MA,NORDESTE,3412,848,2564
2107308,NOVA IORQUE,MA,NORDESTE,2909,532,2377
2107357,NOVA OLINDA DO MARANHÃO,MA,NORDESTE,9133,1783,7350
2107407,OLHO D'ÁGUA DAS CUNHÃS,MA,NORDESTE,10780,2214,8566
2107456,OLINDA NOVA DO MARANHÃO,MA,NORDESTE,7249,1112,6137
2107506,PAÇO DO LUMIAR,MA,NORDESTE,60594,22057,38537
2107605,PALMEIRÂNDIA,MA,NORDESTE,11445,1548,9897
2107704,PARAIBANO,MA,NORDESTE,10690,1740,8950
2107803,PARNARAMA,MA,NORDESTE,18374,2397,15977
2107902,PASSAGEM FRANCA,MA,NORDESTE,10205,1910,8295
2108009,PASTOS BONS,MA,NORDESTE,11132,2156,8976
2108058,PAULINO NEVES,MA,NORDESTE,10624,1757,8867
2108108,PAULO RAMOS,MA,NORDESTE,11901,3103,8798
2108207,PEDREIRAS,MA,NORDESTE,22424,7686,14738
2108256,PEDRO DO ROSÁRIO,MA,NORDESTE,12404,1750,10654
2108306,PENALVA,MA,NORDESTE,17686,2345,15341
2108405,PERI MIRIM,MA,NORDESTE,7848,1340,6508
2108454,PERITORÓ,MA,NORDESTE,12117,2123,9994
2108504,PINDARÉ-MIRIM,MA,NORDESTE,18526,4304,14222
2108603,PINHEIRO,MA,NORDESTE,43911,11124,32787
2108702,PIO XII,MA,NORDESTE,13946,2811,11135
2108801,PIRAPEMAS,MA,NORDESTE,8971,1519,7452
2108900,POÇÃO DE PEDRAS,MA,NORDESTE,10875,2792,8083
2109007,PORTO FRANCO,MA,NORDESTE,13722,5340,8382
2109056,PORTO RICO DO MARANHÃO,MA,NORDESTE,4221,1044,3177
2109106,PRESIDENTE DUTRA,MA,NORDESTE,23707,7653,16054
2109205,PRESIDENTE JUSCELINO,MA,NORDESTE,7008,1149,5859
2109239,PRESIDENTE MÉDICI,MA,NORDESTE,3900,697,3203
2109270,PRESIDENTE SARNEY,MA,NORDESTE,10349,1573,8776
2109304,PRESIDENTE VARGAS,MA,NORDESTE,7144,931,6213
2109403,PRIMEIRA CRUZ,MA,NORDESTE,7027,838,6189
2109452,RAPOSA,MA,NORDESTE,16173,5352,10821
2109502,RIACHÃO,MA,NORDESTE,12280,3413,8867
2109551,RIBAMAR FIQUENE,MA,NORDESTE,4888,1607,3281
2109601,ROSÁRIO,MA,NORDESTE,23393,5248,18145
2109700,SAMBAÍBA,MA,NORDESTE,4034,1225,2809
2109759,SANTA FILOMENA DO MARANHÃO,MA,NORDESTE,4532,879,3653
2109809,SANTA HELENA,MA,NORDESTE,16445,3853,12592
2109908,SANTA INÊS,MA,NORDESTE,45523,15347,30176
2110005,SANTA LUZIA,MA,NORDESTE,32416,7292,25124
2110039,SANTA LUZIA DO PARUÁ,MA,NORDESTE,12623,3485,9138
2110104,SANTA QUITÉRIA DO MARANHÃO,MA,NORDESTE,15392,2650,12742
2110203,SANTA RITA,MA,NORDESTE,18378,3534,14844
2110237,SANTANA DO MARANHÃO,MA,NORDESTE,5567,1058,4509
2110278,SANTO AMARO DO MARANHÃO,MA,NORDESTE,7888,1145,6743
2110302,SANTO ANTÔNIO DOS LOPES,MA,NORDESTE,11330,3015,8315
2110401,SÃO BENEDITO DO RIO PRETO,MA,NORDESTE,11198,1627,9571
2110500,SÃO BENTO,MA,NORDESTE,19709,3770,15939
2110609,SÃO BERNARDO,MA,NORDESTE,15950,3231,12719
2110658,SÃO DOMINGOS DO AZEITÃO,MA,NORDESTE,4953,1156,3797
2110708,SÃO DOMINGOS DO MARANHÃO,MA,NORDESTE,21372,6452,14920
2110807,SÃO FÉLIX DE BALSAS,MA,NORDESTE,2895,623,2272
2110856,SÃO FRANCISCO DO BREJÃO,MA,NORDESTE,5915,2355,3560
2110906,SÃO FRANCISCO DO MARANHÃO,MA,NORDESTE,7034,806,6228
2111003,SÃO JOÃO BATISTA,MA,NORDESTE,13128,1653,11475
2111029,SÃO JOÃO DO CARÚ,MA,NORDESTE,7017,1713,5304
2111052,SÃO JOÃO DO PARAÍSO,MA,NORDESTE,6524,2420,4104
2111078,SÃO JOÃO DO SOTER,MA,NORDESTE,10238,1235,9003
2111102,SÃO JOÃO DOS PATOS,MA,NORDESTE,14735,3152,11583
2111201,SÃO JOSÉ DE RIBAMAR,MA,NORDESTE,90444,32509,57935
2111250,SÃO JOSÉ DOS BASÍLIOS,MA,NORDESTE,4797,698,4099
2111300,SÃO LUÍS,MA,NORDESTE,601416,238285,363131
2111409,SÃO LUÍS GONZAGA DO MARANHÃO,MA,NORDESTE,12876,1812,11064
2111508,SÃO MATEUS DO MARANHÃO,MA,NORDESTE,20790,4920,15870
2111532,SÃO PEDRO DA ÁGUA BRANCA,MA,NORDESTE,6751,2435,4316
2111573,SÃO PEDRO DOS CRENTES,MA,NORDESTE,3496,2179,1317
2111607,SÃO RAIMUNDO DAS MANGABEIRAS,MA,NORDESTE,11249,3412,7837
2111631,SÃO RAIMUNDO DO DOCA BEZERRA,MA,NORDESTE,3799,729,3070
2111672,SÃO ROBERTO,MA,NORDESTE,3472,579,2893
2111706,SÃO VICENTE FERRER,MA,NORDESTE,10858,1707,9151
2111722,SATUBINHA,MA,NORDESTE,5202,1167,4035
2111748,SENADOR ALEXANDRE COSTA,MA,NORDESTE,5910,1239,4671
2111763,SENADOR LA ROCQUE,MA,NORDESTE,9160,2833,6327
2111789,SERRANO DO MARANHÃO,MA,NORDESTE,6114,497,5617
2111805,SÍTIO NOVO,MA,NORDESTE,11086,3605,7481
2111904,SUCUPIRA DO NORTE,MA,NORDESTE,6479,1310,5169
2111953,SUCUPIRA DO RIACHÃO,MA,NORDESTE,3352,390,2962
2112001,TASSO FRAGOSO,MA,NORDESTE,5331,1839,3492
2112100,TIMBIRAS,MA,NORDESTE,14749,2398,12351
2112209,TIMON,MA,NORDESTE,93812,24352,69460
2112233,TRIZIDELA DO VALE,MA,NORDESTE,12931,4050,8881
2112274,TUFILÂNDIA,MA,NORDESTE,4230,744,3486
2112308,TUNTUM,MA,NORDESTE,20563,5850,14713
2112407,TURIAÇU,MA,NORDESTE,18773,3635,15138
2112456,TURILÂNDIA,MA,NORDESTE,10433,2142,8291
2112506,TUTÓIA,MA,NORDESTE,28820,6606,22214
2112605,URBANO SANTOS,MA,NORDESTE,18530,3011,15519
2112704,VARGEM GRANDE,MA,NORDESTE,23071,4049,19022
2112803,VIANA,MA,NORDESTE,28043,7598,20445
2112852,VILA NOVA DOS MARTÍRIOS,MA,NORDESTE,6001,2207,3794
2112902,VITÓRIA DO MEARIM,MA,NORDESTE,17572,4716,12856
2113009,VITORINO FREIRE,MA,NORDESTE,17559,4720,12839
2114007,ZÉ DOCA,MA,NORDESTE,23774,6313,17461
2200053,ACAUÃ,PI,NORDESTE,5229,535,4694
2200103,AGRICOLÂNDIA,PI,NORDESTE,3805,640,3165
2200202,ÁGUA BRANCA,PI,NORDESTE,11927,3351,8576
2200251,ALAGOINHA DO PIAUÍ,PI,NORDESTE,4841,1086,3755
2200277,ALEGRETE DO PIAUÍ,PI,NORDESTE,3220,636,2584
2200301,ALTO LONGÁ,PI,NORDESTE,9884,1612,8272
2200400,ALTOS,PI,NORDESTE,28149,4800,23349
2200459,ALVORADA DO GURGUÉIA,PI,NORDESTE,3454,631,2823
2200509,AMARANTE,PI,NORDESTE,11364,1834,9530
2200608,ANGICAL DO PIAUÍ,PI,NORDESTE,5141,936,4205
2200707,ANÍSIO DE ABREU,PI,NORDESTE,5548,635,4913
2200806,ANTÔNIO ALMEIDA,PI,NORDESTE,2244,648,1596
2200905,AROAZES,PI,NORDESTE,4114,570,3544
2200954,AROEIRAS DO ITAIM,PI,NORDESTE,3187,535,2652
2201002,ARRAIAL,PI,NORDESTE,3185,475,2710
2201051,ASSUNÇÃO DO PIAUÍ,PI,NORDESTE,4989,530,4459
2201101,AVELINO LOPES,PI,NORDESTE,6825,1535,5290
2201150,BAIXA GRANDE DO RIBEIRO,PI,NORDESTE,8160,2437,5723
2201176,BARRA D'ALCÂNTARA,PI,NORDESTE,2553,375,2178
2201200,BARRAS,PI,NORDESTE,27224,5883,21341
2201309,BARREIRAS DO PIAUÍ,PI,NORDESTE,2446,475,1971
2201408,BARRO DURO,PI,NORDESTE,4397,1103,3294
2201507,BATALHA,PI,NORDESTE,15646,3707,11939
2201556,BELA VISTA DO PIAUÍ,PI,NORDESTE,2829,442,2387
2201572,BELÉM DO PIAUÍ,PI,NORDESTE,2441,379,2062
2201606,BENEDITINOS,PI,NORDESTE,7310,1005,6305
2201705,BERTOLÍNIA,PI,NORDESTE,3542,933,2609
2201739,BETÂNIA DO PIAUÍ,PI,NORDESTE,4332,377,3955
2201770,BOA HORA,PI,NORDESTE,4779,902,3877
2201804,BOCAINA,PI,NORDESTE,4249,942,3307
2201903,BOM JESUS,PI,NORDESTE,15177,4623,10554
2201919,BOM PRINCÍPIO DO PIAUÍ,PI,NORDESTE,4812,1023,3789
2201929,BONFIM DO PIAUÍ,PI,NORDESTE,3869,287,3582
2201945,BOQUEIRÃO DO PIAUÍ,PI,NORDESTE,4007,534,3473
2201960,BRASILEIRA,PI,NORDESTE,5728,864,4864
2201988,BREJO DO PIAUÍ,PI,NORDESTE,3036,291,2745
2202000,BURITI DOS LOPES,PI,NORDESTE,13064,3349,9715
2202026,BURITI DOS MONTES,PI,NORDESTE,5239,633,4606
2202059,CABECEIRAS DO PIAUÍ,PI,NORDESTE,6833,842,5991
2202075,CAJAZEIRAS DO PIAUÍ,PI,NORDESTE,2571,368,2203
2202083,CAJUEIRO DA PRAIA,PI,NORDESTE,5513,1095,4418
2202091,CALDEIRÃO GRANDE DO PIAUÍ,PI,NORDESTE,4134,669,3465
2202109,CAMPINAS DO PIAUÍ,PI,NORDESTE,3946,272,3674
2202117,CAMPO ALEGRE DO FIDALGO,PI,NORDESTE,3562,366,3196
2202133,CAMPO GRANDE DO PIAUÍ,PI,NORDESTE,3867,476,3391
2202174,CAMPO LARGO DO PIAUÍ,PI,NORDESTE,3971,710,3261
2202208,CAMPO MAIOR,PI,NORDESTE,28107,7034,21073
2202251,CANAVIEIRA,PI,NORDESTE,2448,374,2074
2202307,CANTO DO BURITI,PI,NORDESTE,11534,2275,9259
2202406,CAPITÃO DE CAMPOS,PI,NORDESTE,7661,1264,6397
2202455,CAPITÃO GERVÁSIO OLIVEIRA,PI,NORDESTE,2991,226,2765
2202505,CARACOL,PI,NORDESTE,6324,831,5493
2202539,CARAÚBAS DO PIAUÍ,PI,NORDESTE,3908,872,3036
2202554,CARIDADE DO PIAUÍ,PI,NORDESTE,3516,383,3133
2202604,CASTELO DO PIAUÍ,PI,NORDESTE,11724,2706,9018
2202653,CAXINGÓ,PI,NORDESTE,4269,628,3641
2202703,COCAL,PI,NORDESTE,16808,3634,13174
2202711,COCAL DE TELHA,PI,NORDESTE,3357,406,2951
2202729,COCAL DOS ALVES,PI,NORDESTE,4309,397,3912
2202737,COIVARAS,PI,NORDESTE,4191,805,3386
2202752,COLÔNIA DO GURGUÉIA,PI,NORDESTE,3994,755,3239
2202778,COLÔNIA DO PIAUÍ,PI,NORDESTE,4544,603,3941
2202802,CONCEIÇÃO DO CANINDÉ,PI,NORDESTE,3485,483,3002
2202851,CORONEL JOSÉ DIAS,PI,NORDESTE,3912,315,3597
2202901,CORRENTE,PI,NORDESTE,15522,3968,11554
2203008,CRISTALÂNDIA DO PIAUÍ,PI,NORDESTE,4284,761,3523
2203107,CRISTINO CASTRO,PI,NORDESTE,5863,1115,4748
2203206,CURIMATÁ,PI,NORDESTE,6854,1786,5068
2203230,CURRAIS,PI,NORDESTE,4163,693,3470
2203255,CURRALINHOS,PI,NORDESTE,3867,523,3344
2203271,CURRAL NOVO DO PIAUÍ,PI,NORDESTE,3684,292,3392
2203305,DEMERVAL LOBÃO,PI,NORDESTE,9687,2189,7498
2203354,DIRCEU ARCOVERDE,PI,NORDESTE,4704,462,4242
2203404,DOM EXPEDITO LOPES,PI,NORDESTE,5207,1007,4200
2203420,DOMINGOS MOURÃO,PI,NORDESTE,3207,392,2815
2203453,DOM INOCÊNCIO,PI,NORDESTE,5814,562,5252
2203503,ELESBÃO VELOSO,PI,NORDESTE,9215,1370,7845
2203602,ELISEU MARTINS,PI,NORDESTE,2756,486,2270
2203701,ESPERANTINA,PI,NORDESTE,22882,6006,16876
2203750,FARTURA DO PIAUÍ,PI,NORDESTE,3530,264,3266
2203800,FLORES DO PIAUÍ,PI,NORDESTE,3017,479,2538
2203859,FLORESTA DO PIAUÍ,PI,NORDESTE,1863,228,1635
2203909,FLORIANO,PI,NORDESTE,34627,8425,26202
2204006,FRANCINÓPOLIS,PI,NORDESTE,3176,393,2783
2204105,FRANCISCO AYRES,PI,NORDESTE,3367,510,2857
2204154,FRANCISCO MACEDO,PI,NORDESTE,2142,322,1820
2204204,FRANCISCO SANTOS,PI,NORDESTE,5483,867,4616
2204303,FRONTEIRAS,PI,NORDESTE,7085,1381,5704
2204352,GEMINIANO,PI,NORDESTE,4945,719,4226
2204402,GILBUÉS,PI,NORDESTE,6162,1129,5033
2204501,GUADALUPE,PI,NORDESTE,6149,1206,4943
2204550,GUARIBAS,PI,NORDESTE,3142,193,2949
2204600,HUGO NAPOLEÃO,PI,NORDESTE,3128,574,2554
2204659,ILHA GRANDE,PI,NORDESTE,6749,1256,5493
2204709,INHUMA,PI,NORDESTE,9655,1646,8009
2204808,IPIRANGA DO PIAUÍ,PI,NORDESTE,5834,675,5159
2204907,ISAÍAS COELHO,PI,NORDESTE,4853,384,4469
2205003,ITAINÓPOLIS,PI,NORDESTE,7570,1256,6314
2205102,ITAUEIRA,PI,NORDESTE,6622,1330,5292
2205151,JACOBINA DO PIAUÍ,PI,NORDESTE,4183,577,3606
2205201,JAICÓS,PI,NORDESTE,9784,1614,8170
2205250,JARDIM DO MULATO,PI,NORDESTE,3302,704,2598
2205276,JATOBÁ DO PIAUÍ,PI,NORDESTE,5027,733,4294
2205300,JERUMENHA,PI,NORDESTE,3442,654,2788
2205359,JOÃO COSTA,PI,NORDESTE,2675,364,2311
2205409,JOAQUIM PIRES,PI,NORDESTE,8852,1956,6896
2205458,JOCA MARQUES,PI,NORDESTE,3665,683,2982
2205508,JOSÉ DE FREITAS,PI,NORDESTE,27441,3840,23601
2205516,JUAZEIRO DO PIAUÍ,PI,NORDESTE,4179,759,3420
2205524,JÚLIO BORGES,PI,NORDESTE,3458,418,3040
2205532,JUREMA,PI,NORDESTE,3732,445,3287
2205540,LAGOINHA DO PIAUÍ,PI,NORDESTE,2381,421,1960
2205557,LAGOA ALEGRE,PI,NORDESTE,6323,845,5478
2205565,LAGOA DO BARRO DO PIAUÍ,PI,NORDESTE,3509,400,3109
2205573,LAGOA DE SÃO FRANCISCO,PI,NORDESTE,4424,683,3741
2205581,LAGOA DO PIAUÍ,PI,NORDESTE,3609,734,2875
2205599,LAGOA DO SÍTIO,PI,NORDESTE,3505,494,3011
2205607,LANDRI SALES,PI,NORDESTE,3335,507,2828
2205706,LUÍS CORREIA,PI,NORDESTE,20015,4364,15651
2205805,LUZILÂNDIA,PI,NORDESTE,14734,3183,11551
2205854,MADEIRO,PI,NORDESTE,4572,774,3798
2205904,MANOEL EMÍDIO,PI,NORDESTE,3512,527,2985
2205953,MARCOLÂNDIA,PI,NORDESTE,6064,1517,4547
2206001,MARCOS PARENTE,PI,NORDESTE,3002,834,2168
2206050,MASSAPÊ DO PIAUÍ,PI,NORDESTE,4522,415,4107
2206100,MATIAS OLÍMPIO,PI,NORDESTE,6325,1251,5074
2206209,MIGUEL ALVES,PI,NORDESTE,18278,2991,15287
2206308,MIGUEL LEÃO,PI,NORDESTE,1234,467,767
2206357,MILTON BRANDÃO,PI,NORDESTE,4909,1560,3349
2206407,MONSENHOR GIL,PI,NORDESTE,8030,1492,6538
2206506,MONSENHOR HIPÓLITO,PI,NORDESTE,5526,792,4734
2206605,MONTE ALEGRE DO PIAUÍ,PI,NORDESTE,6656,952,5704
2206654,MORRO CABEÇA NO TEMPO,PI,NORDESTE,2685,554,2131
2206670,MORRO DO CHAPÉU DO PIAUÍ,PI,NORDESTE,4013,709,3304
2206696,MURICI DOS PORTELAS,PI,NORDESTE,4424,802,3622
2206704,NAZARÉ DO PIAUÍ,PI,NORDESTE,4954,470,4484
2206720,NAZÁRIA,PI,NORDESTE,8834,1678,7156
2206753,NOSSA SENHORA DE NAZARÉ,PI,NORDESTE,4426,557,3869
2206803,NOSSA SENHORA DOS REMÉDIOS,PI,NORDESTE,6325,1267,5058
2206902,NOVO ORIENTE DO PIAUÍ,PI,NORDESTE,3810,416,3394
2206951,NOVO SANTO ANTÔNIO,PI,NORDESTE,3419,414,3005
2207009,OEIRAS,PI,NORDESTE,22939,5162,17777
2207108,OLHO D'ÁGUA DO PIAUÍ,PI,NORDESTE,1812,330,1482
2207207,PADRE MARCOS,PI,NORDESTE,4667,774,3893
2207306,PAES LANDIM,PI,NORDESTE,2999,812,2187
2207355,PAJEÚ DO PIAUÍ,PI,NORDESTE,2526,390,2136
2207405,PALMEIRA DO PIAUÍ,PI,NORDESTE,3422,733,2689
2207504,PALMEIRAIS,PI,NORDESTE,9490,1279,8211
2207553,PAQUETÁ,PI,NORDESTE,3220,544,2676
2207603,PARNAGUÁ,PI,NORDESTE,5397,820,4577
2207702,PARNAÍBA,PI,NORDESTE,87942,30185,57757
2207751,PASSAGEM FRANCA DO PIAUÍ,PI,NORDESTE,2764,623,2141
2207777,PATOS DO PIAUÍ,PI,NORDESTE,4085,499,3586
2207793,PAU D'ARCO DO PIAUÍ,PI,NORDESTE,3931,594,3337
2207801,PAULISTANA,PI,NORDESTE,12672,1891,10781
2207850,PAVUSSU,PI,NORDESTE,2816,282,2534
2207900,PEDRO II,PI,NORDESTE,24184,5641,18543
2207934,PEDRO LAURENTINO,PI,NORDESTE,2197,654,1543
2207959,NOVA SANTA RITA,PI,NORDESTE,3188,254,2934
2208007,PICOS,PI,NORDESTE,43224,11563,31661
2208106,PIMENTEIRAS,PI,NORDESTE,6842,1141,5701
2208205,PIO IX,PI,NORDESTE,11223,1576,9647
2208304,PIRACURUCA,PI,NORDESTE,18740,4130,14610
2208403,PIRIPIRI,PI,NORDESTE,37560,9279,28281
2208502,PORTO,PI,NORDESTE,6457,1527,4930
2208551,PORTO ALEGRE DO PIAUÍ,PI,NORDESTE,1516,312,1204
2208601,PRATA DO PIAUÍ,PI,NORDESTE,2468,287,2181
2208650,QUEIMADA NOVA,PI,NORDESTE,5693,718,4975
2208700,REDENÇÃO DO GURGUÉIA,PI,NORDESTE,4933,1367,3566
2208809,REGENERAÇÃO,PI,NORDESTE,10048,1365,8683
2208858,RIACHO FRIO,PI,NORDESTE,3172,340,2832
2208874,RIBEIRA DO PIAUÍ,PI,NORDESTE,2702,357,2345
2208908,RIBEIRO GONÇALVES,PI,NORDESTE,3968,989,2979
2209005,RIO GRANDE DO PIAUÍ,PI,NORDESTE,4045,559,3486
2209104,SANTA CRUZ DO PIAUÍ,PI,NORDESTE,4337,628,3709
2209153,SANTA CRUZ DOS MILAGRES,PI,NORDESTE,2509,402,2107
2209203,SANTA FILOMENA,PI,NORDESTE,3963,1036,2927
2209302,SANTA LUZ,PI,NORDESTE,3982,959,3023
2209351,SANTANA DO PIAUÍ,PI,NORDESTE,3309,589,2720
2209377,SANTA ROSA DO PIAUÍ,PI,NORDESTE,3371,745,2626
2209401,SANTO ANTÔNIO DE LISBOA,PI,NORDESTE,4648,1031,3617
2209450,SANTO ANTÔNIO DOS MILAGRES,PI,NORDESTE,1467,244,1223
2209500,SANTO INÁCIO DO PIAUÍ,PI,NORDESTE,2623,360,2263
2209559,SÃO BRAZ DO PIAUÍ,PI,NORDESTE,3163,242,2921
2209609,SÃO FÉLIX DO PIAUÍ,PI,NORDESTE,2665,712,1953
2209658,SÃO FRANCISCO DE ASSIS DO PIAUÍ,PI,NORDESTE,3743,844,2899
2209708,SÃO FRANCISCO DO PIAUÍ,PI,NORDESTE,4301,1227,3074
2209757,SÃO GONÇALO DO GURGUÉIA,PI,NORDESTE,1974,361,1613
2209807,SÃO GONÇALO DO PIAUÍ,PI,NORDESTE,3482,840,2642
2209856,SÃO JOÃO DA CANABRAVA,PI,NORDESTE,3650,479,3171
2209872,SÃO JOÃO DA FRONTEIRA,PI,NORDESTE,3691,652,3039
2209906,SÃO JOÃO DA SERRA,PI,NORDESTE,4864,856,4008
2209955,SÃO JOÃO DA VARJOTA,PI,NORDESTE,2987,533,2454
2209971,SÃO JOÃO DO ARRAIAL,PI,NORDESTE,5513,1454,4059
2210003,SÃO JOÃO DO PIAUÍ,PI,NORDESTE,11579,2220,9359
2210052,SÃO JOSÉ DO DIVINO,PI,NORDESTE,3918,610,3308
2210102,SÃO JOSÉ DO PEIXE,PI,NORDESTE,2262,319,1943
2210201,SÃO JOSÉ DO PIAUÍ,PI,NORDESTE,4613,666,3947
2210300,SÃO JULIÃO,PI,NORDESTE,4087,1227,2860
2210359,SÃO LOURENÇO DO PIAUÍ,PI,NORDESTE,3978,331,3647
2210375,SÃO LUIS DO PIAUÍ,PI,NORDESTE,2206,375,1831
2210383,SÃO MIGUEL DA BAIXA GRANDE,PI,NORDESTE,1901,385,1516
2210391,SÃO MIGUEL DO FIDALGO,PI,NORDESTE,2104,194,1910
2210409,SÃO MIGUEL DO TAPUIO,PI,NORDESTE,11152,1548,9604
2210508,SÃO PEDRO DO PIAUÍ,PI,NORDESTE,8622,1905,6717
2210607,SÃO RAIMUNDO NONATO,PI,NORDESTE,20852,3159,17693
2210623,SEBASTIÃO BARROS,PI,NORDESTE,3334,534,2800
2210631,SEBASTIÃO LEAL,PI,NORDESTE,3328,1121,2207
2210656,SIGEFREDO PACHECO,PI,NORDESTE,6794,1039,5755
2210706,SIMÕES,PI,NORDESTE,9009,1290,7719
2210805,SIMPLÍCIO MENDES,PI,NORDESTE,7673,1241,6432
2210904,SOCORRO DO PIAUÍ,PI,NORDESTE,2978,513,2465
2210938,SUSSUAPARA,PI,NORDESTE,5221,823,4398
2210953,TAMBORIL DO PIAUÍ,PI,NORDESTE,2069,299,1770
2210979,TANQUE DO PIAUÍ,PI,NORDESTE,1850,326,1524
2211001,TERESINA,PI,NORDESTE,478476,160558,317918
2211100,UNIÃO,PI,NORDESTE,28662,6079,22583
2211209,URUÇUÍ,PI,NORDESTE,13915,4218,9697
2211308,VALENÇA DO PIAUÍ,PI,NORDESTE,12903,2661,10242
2211357,VÁRZEA BRANCA,PI,NORDESTE,3605,350,3255
2211407,VÁRZEA GRANDE,PI,NORDESTE,2819,500,2319
2211506,VERA MENDES,PI,NORDESTE,2612,306,2306
2211605,VILA NOVA DO PIAUÍ,PI,NORDESTE,2263,414,1849
2211704,WALL FERRAZ,PI,NORDESTE,3251,675,2576
2300101,ABAIARA,CE,NORDESTE,5750,725,5025
2300150,ACARAPE,CE,NORDESTE,9788,3526,6262
2300200,ACARAÚ,CE,NORDESTE,35709,9596,26113
2300309,ACOPIARA,CE,NORDESTE,30144,5000,25144
2300408,AIUABA,CE,NORDESTE,8359,961,7398
2300507,ALCÂNTARAS,CE,NORDESTE,7382,1010,6372
2300606,ALTANEIRA,CE,NORDESTE,4990,458,4532
2300705,ALTO SANTO,CE,NORDESTE,9764,1776,7988
2300754,AMONTADA,CE,NORDESTE,25759,5691,20068
2300804,ANTONINA DO NORTE,CE,NORDESTE,5071,653,4418
2300903,APUIARÉS,CE,NORDESTE,9862,2033,7829
2301000,AQUIRAZ,CE,NORDESTE,50954,17580,33374
2301109,ARACATI,CE,NORDESTE,45080,13449,31631
2301208,ARACOIABA,CE,NORDESTE,19677,4757,14920
2301257,ARARENDÁ,CE,NORDESTE,7261,1618,5643
2301307,ARARIPE,CE,NORDESTE,12964,1104,11860
2301406,ARATUBA,CE,NORDESTE,9242,1926,7316
2301505,ARNEIROZ,CE,NORDESTE,5069,888,4181
2301604,ASSARÉ,CE,NORDESTE,14341,1859,12482
2301703,AURORA,CE,NORDESTE,15146,2359,12787
2301802,BAIXIO,CE,NORDESTE,4216,543,3673
2301851,BANABUIÚ,CE,NORDESTE,11573,1941,9632
2301901,BARBALHA,CE,NORDESTE,39321,9367,29954
2301950,BARREIRA,CE,NORDESTE,14737,5704,9033
2302008,BARRO,CE,NORDESTE,12461,1529,10932
2302057,BARROQUINHA,CE,NORDESTE,10619,1918,8701
2302107,BATURITÉ,CE,NORDESTE,21712,5078,16634
2302206,BEBERIBE,CE,NORDESTE,35219,10115,25104
2302305,BELA CRUZ,CE,NORDESTE,15908,4665,11243
2302404,BOA VIAGEM,CE,NORDESTE,31028,4117,26911
2302503,BREJO SANTO,CE,NORDESTE,28709,5202,23507
2302602,CAMOCIM,CE,NORDESTE,37583,10303,27280
2302701,CAMPOS SALES,CE,NORDESTE,15284,2106,13178
2302800,CANINDÉ,CE,NORDESTE,45191,9206,35985
2302909,CAPISTRANO,CE,NORDESTE,12676,2430,10246
2303006,CARIDADE,CE,NORDESTE,13095,2420,10675
2303105,CARIRÉ,CE,NORDESTE,11571,2781,8790
2303204,CARIRIAÇU,CE,NORDESTE,18725,3279,15446
2303303,CARIÚS,CE,NORDESTE,11807,1885,9922
2303402,CARNAUBAL,CE,NORDESTE,10380,2939,7441
2303501,CASCAVEL,CE,NORDESTE,46544,14643,31901
2303600,CATARINA,CE,NORDESTE,6493,1123,5370
2303659,CATUNDA,CE,NORDESTE,6726,878,5848
2303709,CAUCAIA,CE,NORDESTE,195880,74827,121053
2303808,CEDRO,CE,NORDESTE,15442,2504,12938
2303907,CHAVAL,CE,NORDESTE,8170,1383,6787
2303931,CHORÓ,CE,NORDESTE,8599,1492,7107
2303956,CHOROZINHO,CE,NORDESTE,14083,3743,10340
2304004,COREAÚ,CE,NORDESTE,14779,3106,11673
2304103,CRATEÚS,CE,NORDESTE,44603,10119,34484
2304202,CRATO,CE,NORDESTE,78545,12363,66182
2304236,CROATÁ,CE,NORDESTE,10909,1931,8978
2304251,CRUZ,CE,NORDESTE,17361,6285,11076
2304269,DEPUTADO IRAPUAN PINHEIRO,CE,NORDESTE,5780,675,5105
2304277,ERERÊ,CE,NORDESTE,4233,603,3630
2304285,EUSÉBIO,CE,NORDESTE,41415,18458,22957
2304301,FARIAS BRITO,CE,NORDESTE,13339,1616,11723
2304350,FORQUILHA,CE,NORDESTE,15020,4633,10387
2304400,FORTALEZA,CE,NORDESTE,1513568,633009,880559
2304459,FORTIM,CE,NORDESTE,11931,3694,8237
2304509,FRECHEIRINHA,CE,NORDESTE,10327,2505,7822
2304608,GENERAL SAMPAIO,CE,NORDESTE,5745,1037,4708
2304657,GRAÇA,CE,NORDESTE,9322,1070,8252
2304707,GRANJA,CE,NORDESTE,33400,4545,28855
2304806,GRANJEIRO,CE,NORDESTE,4289,499,3790
2304905,GROAÍRAS,CE,NORDESTE,7139,2189,4950
2304954,GUAIÚBA,CE,NORDESTE,16242,3967,12275
2305001,GUARACIABA DO NORTE,CE,NORDESTE,25178,5956,19222
2305100,GUARAMIRANGA,CE,NORDESTE,4718,1004,3714
2305209,HIDROLÂNDIA,CE,NORDESTE,11853,2500,9353
2305233,HORIZONTE,CE,NORDESTE,47110,16774,30336
2305266,IBARETAMA,CE,NORDESTE,9569,1851,7718
2305308,IBIAPINA,CE,NORDESTE,14496,3666,10830
2305332,IBICUITINGA,CE,NORDESTE,9572,2271,7301
2305357,ICAPUÍ,CE,NORDESTE,13726,4190,9536
2305407,ICÓ,CE,NORDESTE,37166,7263,29903
2305506,IGUATU,CE,NORDESTE,56364,10351,46013
2305605,INDEPENDÊNCIA,CE,NORDESTE,15835,3938,11897
2305654,IPAPORANGA,CE,NORDESTE,7651,1457,6194
2305704,IPAUMIRIM,CE,NORDESTE,7263,1150,6113
2305803,IPU,CE,NORDESTE,25327,4923,20404
2305902,IPUEIRAS,CE,NORDESTE,22734,4876,17858
2306009,IRACEMA,CE,NORDESTE,8950,1542,7408
2306108,IRAUÇUBA,CE,NORDESTE,15090,2738,12352
2306207,ITAIÇABA,CE,NORDESTE,5648,1619,4029
2306256,ITAITINGA,CE,NORDESTE,25216,8733,16483
2306306,ITAPAGÉ,CE,NORDESTE,31344,10782,20562
2306405,ITAPIPOCA,CE,NORDESTE,76371,17238,59133
2306504,ITAPIÚNA,CE,NORDESTE,12263,2888,9375
2306553,ITAREMA,CE,NORDESTE,24430,8404,16026
2306603,ITATIRA,CE,NORDESTE,13674,2273,11401
2306702,JAGUARETAMA,CE,NORDESTE,11900,1940,9960
2306801,JAGUARIBARA,CE,NORDESTE,6795,1287,5508
2306900,JAGUARIBE,CE,NORDESTE,21940,4151,17789
2307007,JAGUARUANA,CE,NORDESTE,22030,6922,15108
2307106,JARDIM,CE,NORDESTE,16570,2444,14126
2307205,JATI,CE,NORDESTE,5221,779,4442
2307254,JIJOCA DE JERICOACOARA,CE,NORDESTE,14651,4735,9916
2307304,JUAZEIRO DO NORTE,CE,NORDESTE,151382,35858,115524
2307403,JUCÁS,CE,NORDESTE,14862,2949,11913
2307502,LAVRAS DA MANGABEIRA,CE,NORDESTE,17659,2718,14941
2307601,LIMOEIRO DO NORTE,CE,NORDESTE,37672,9010,28662
2307635,MADALENA,CE,NORDESTE,10882,1809,9073
2307650,MARACANAÚ,CE,NORDESTE,144265,56677,87588
2307700,MARANGUAPE,CE,NORDESTE,65887,22496,43391
2307809,MARCO,CE,NORDESTE,17604,8100,9504
2307908,MARTINÓPOLE,CE,NORDESTE,8074,1235,6839
2308005,MASSAPÊ,CE,NORDESTE,24641,6362,18279
2308104,MAURITI,CE,NORDESTE,27079,5901,21178
2308203,MERUOCA,CE,NORDESTE,9966,2001,7965
2308302,MILAGRES,CE,NORDESTE,17038,1993,15045
2308351,MILHÃ,CE,NORDESTE,8853,1318,7535
2308377,MIRAÍMA,CE,NORDESTE,9162,1287,7875
2308401,MISSÃO VELHA,CE,NORDESTE,23643,3913,19730
2308500,MOMBAÇA,CE,NORDESTE,24159,4377,19782
2308609,MONSENHOR TABOSA,CE,NORDESTE,10887,1882,9005
2308708,MORADA NOVA,CE,NORDESTE,43468,11243,32225
2308807,MORAÚJO,CE,NORDESTE,5841,1263,4578
2308906,MORRINHOS,CE,NORDESTE,13774,6594,7180
2309003,MUCAMBO,CE,NORDESTE,9305,1791,7514
2309102,MULUNGU,CE,NORDESTE,6956,1593,5363
2309201,NOVA OLINDA,CE,NORDESTE,9780,1660,8120
2309300,NOVA RUSSAS,CE,NORDESTE,18399,5693,12706
2309409,NOVO ORIENTE,CE,NORDESTE,17220,2806,14414
2309458,OCARA,CE,NORDESTE,18847,4742,14105
2309508,ORÓS,CE,NORDESTE,13542,2709,10833
2309607,PACAJUS,CE,NORDESTE,42560,15370,27190
2309706,PACATUBA,CE,NORDESTE,43321,15994,27327
2309805,PACOTI,CE,NORDESTE,8172,1734,6438
2309904,PACUJÁ,CE,NORDESTE,4606,578,4028
2310001,PALHANO,CE,NORDESTE,7260,2255,5005
2310100,PALMÁCIA,CE,NORDESTE,7392,1820,5572
2310209,PARACURU,CE,NORDESTE,25163,7583,17580
2310258,PARAIPABA,CE,NORDESTE,20947,7736,13211
2310308,PARAMBU,CE,NORDESTE,19331,5529,13802
2310407,PARAMOTI,CE,NORDESTE,7849,1580,6269
2310506,PEDRA BRANCA,CE,NORDESTE,24965,3081,21884
2310605,PENAFORTE,CE,NORDESTE,6492,1067,5425
2310704,PENTECOSTE,CE,NORDESTE,25696,6145,19551
2310803,PEREIRO,CE,NORDESTE,11017,1643,9374
2310852,PINDORETAMA,CE,NORDESTE,15584,4234,11350
2310902,PIQUET CARNEIRO,CE,NORDESTE,9586,1407,8179
2310951,PIRES FERREIRA,CE,NORDESTE,6531,1220,5311
2311009,PORANGA,CE,NORDESTE,7377,1041,6336
2311108,PORTEIRAS,CE,NORDESTE,10877,1398,9479
2311207,POTENGI,CE,NORDESTE,5839,576,5263
2311231,POTIRETAMA,CE,NORDESTE,4674,672,4002
2311264,QUITERIANÓPOLIS,CE,NORDESTE,12630,1948,10682
2311306,QUIXADÁ,CE,NORDESTE,47017,16776,30241
2311355,QUIXELÔ,CE,NORDESTE,11932,1738,10194
2311405,QUIXERAMOBIM,CE,NORDESTE,45923,9242,36681
2311504,QUIXERÉ,CE,NORDESTE,14468,3378,11090
2311603,REDENÇÃO,CE,NORDESTE,18655,5110,13545
2311702,RERIUTABA,CE,NORDESTE,12200,2075,10125
2311801,RUSSAS,CE,NORDESTE,46180,13306,32874
2311900,SABOEIRO,CE,NORDESTE,9107,1447,7660
2311959,SALITRE,CE,NORDESTE,10778,1744,9034
2312007,SANTANA DO ACARAÚ,CE,NORDESTE,19965,3997,15968
2312106,SANTANA DO CARIRI,CE,NORDESTE,10631,1082,9549
2312205,SANTA QUITÉRIA,CE,NORDESTE,26191,4530,21661
2312304,SÃO BENEDITO,CE,NORDESTE,28130,7153,20977
2312403,SÃO GONÇALO DO AMARANTE,CE,NORDESTE,37446,13070,24376
2312502,SÃO JOÃO DO JAGUARIBE,CE,NORDESTE,4807,804,4003
2312601,SÃO LUÍS DO CURU,CE,NORDESTE,8828,2273,6555
2312700,SENADOR POMPEU,CE,NORDESTE,16132,4395,11737
2312809,SENADOR SÁ,CE,NORDESTE,5128,1098,4030
2312908,SOBRAL,CE,NORDESTE,120204,37230,82974
2313005,SOLONÓPOLE,CE,NORDESTE,11193,1681,9512
2313104,TABULEIRO DO NORTE,CE,NORDESTE,19892,3856,16036
2313203,TAMBORIL,CE,NORDESTE,16482,2985,13497
2313252,TARRAFAS,CE,NORDESTE,5478,607,4871
2313302,TAUÁ,CE,NORDESTE,34464,10400,24064
2313351,TEJUÇUOCA,CE,NORDESTE,11867,2368,9499
2313401,TIANGUÁ,CE,NORDESTE,45559,16204,29355
2313500,TRAIRI,CE,NORDESTE,35893,9276,26617
2313559,TURURU,CE,NORDESTE,11569,2861,8708
2313609,UBAJARA,CE,NORDESTE,20309,6095,14214
2313708,UMARI,CE,NORDESTE,4817,1073,3744
2313757,UMIRIM,CE,NORDESTE,11867,2650,9217
2313807,URUBURETAMA,CE,NORDESTE,14285,3731,10554
2313906,URUOCA,CE,NORDESTE,8702,1831,6871
2313955,VARJOTA,CE,NORDESTE,12208,3381,8827
2314003,VÁRZEA ALEGRE,CE,NORDESTE,24718,4185,20533
2314102,VIÇOSA DO CEARÁ,CE,NORDESTE,35961,8215,27746
2400109,ACARI,RN,NORDESTE,7237,2305,4932
2400208,AÇU,RN,NORDESTE,34741,8733,26008
2400307,AFONSO BEZERRA,RN,NORDESTE,7286,1942,5344
2400406,ÁGUA NOVA,RN,NORDESTE,2294,258,2036
2400505,ALEXANDRIA,RN,NORDESTE,8604,1292,7312
2400604,ALMINO AFONSO,RN,NORDESTE,3965,676,3289
2400703,ALTO DO RODRIGUES,RN,NORDESTE,8921,1723,7198
2400802,ANGICOS,RN,NORDESTE,7715,2368,5347
2400901,ANTÔNIO MARTINS,RN,NORDESTE,4513,621,3892
2401008,APODI,RN,NORDESTE,24104,5311,18793
2401107,AREIA BRANCA,RN,NORDESTE,16463,5198,11265
2401206,ARÊS,RN,NORDESTE,9022,2829,6193
2401305,CAMPO GRANDE,RN,NORDESTE,6655,4784,1871
2401404,BAÍA FORMOSA,RN,NORDESTE,5432,1961,3471
2401453,BARAÚNA,RN,NORDESTE,16777,5181,11596
2401503,BARCELONA,RN,NORDESTE,3587,1376,2211
2401602,BENTO FERNANDES,RN,NORDESTE,3851,807,3044
2401651,BODÓ,RN,NORDESTE,2693,541,2152
2401701,BOM JESUS,RN,NORDESTE,6921,4458,2463
2401800,BREJINHO,RN,NORDESTE,7821,2304,5517
2401859,CAIÇARA DO NORTE,RN,NORDESTE,4003,1308,2695
2401909,CAIÇARA DO RIO DO VENTO,RN,NORDESTE,2900,731,2169
2402006,CAICÓ,RN,NORDESTE,36607,12443,24164
2402105,CAMPO REDONDO,RN,NORDESTE,6416,1084,5332
2402204,CANGUARETAMA,RN,NORDESTE,18518,4469,14049
2402303,CARAÚBAS,RN,NORDESTE,14952,3129,11823
2402402,CARNAÚBA DOS DANTAS,RN,NORDESTE,4865,2072,2793
2402501,CARNAUBAIS,RN,NORDESTE,6942,1524,5418
2402600,CEARÁ-MIRIM,RN,NORDESTE,45207,12481,32726
2402709,CERRO CORÁ,RN,NORDESTE,6883,1481,5402
2402808,CORONEL EZEQUIEL,RN,NORDESTE,3435,747,2688
2402907,CORONEL JOÃO PESSOA,RN,NORDESTE,3090,466,2624
2403004,CRUZETA,RN,NORDESTE,5322,1257,4065
2403103,CURRAIS NOVOS,RN,NORDESTE,24656,9038,15618
2403202,DOUTOR SEVERIANO,RN,NORDESTE,4779,662,4117
2403251,PARNAMIRIM,RN,NORDESTE,112525,60389,52136
2403301,ENCANTO,RN,NORDESTE,3876,539,3337
2403400,EQUADOR,RN,NORDESTE,3656,1061,2595
2403509,ESPÍRITO SANTO,RN,NORDESTE,5930,2448,3482
2403608,EXTREMOZ,RN,NORDESTE,23116,9793,13323
2403707,FELIPE GUERRA,RN,NORDESTE,5679,910,4769
2403756,FERNANDO PEDROZA,RN,NORDESTE,2447,669,1778
2403806,FLORÂNIA,RN,NORDESTE,6444,1573,4871
2403905,FRANCISCO DANTAS,RN,NORDESTE,2248,389,1859
2404002,FRUTUOSO GOMES,RN,NORDESTE,3163,529,2634
2404101,GALINHOS,RN,NORDESTE,1850,776,1074
2404200,GOIANINHA,RN,NORDESTE,16810,5885,10925
2404309,GOVERNADOR DIX-SEPT ROSADO,RN,NORDESTE,9480,1930,7550
2404408,GROSSOS,RN,NORDESTE,7217,2223,4994
2404507,GUAMARÉ,RN,NORDESTE,11525,3422,8103
2404606,IELMO MARINHO,RN,NORDESTE,8701,2668,6033
2404705,IPANGUAÇU,RN,NORDESTE,10098,1840,8258
2404804,IPUEIRA,RN,NORDESTE,1657,341,1316
2404853,ITAJÁ,RN,NORDESTE,5073,1379,3694
2404903,ITAÚ,RN,NORDESTE,3879,826,3053
2405009,JAÇANÃ,RN,NORDESTE,4730,1098,3632
2405108,JANDAÍRA,RN,NORDESTE,4505,1236,3269
2405207,JANDUÍS,RN,NORDESTE,3423,628,2795
2405306,JANUÁRIO CICCO,RN,NORDESTE,5873,2193,3680
2405405,JAPI,RN,NORDESTE,4299,740,3559
2405504,JARDIM DE ANGICOS,RN,NORDESTE,2200,464,1736
2405603,JARDIM DE PIRANHAS,RN,NORDESTE,8666,1481,7185
2405702,JARDIM DO SERIDÓ,RN,NORDESTE,8152,2574,5578
2405801,JOÃO CÂMARA,RN,NORDESTE,20294,5631,14663
2405900,JOÃO DIAS,RN,NORDESTE,2048,376,1672
2406007,JOSÉ DA PENHA,RN,NORDESTE,4129,526,3603
2406106,JUCURUTU,RN,NORDESTE,12099,3123,8976
2406155,JUNDIÁ,RN,NORDESTE,3192,1016,2176
2406205,LAGOA D'ANTA,RN,NORDESTE,4458,992,3466
2406304,LAGOA DE PEDRAS,RN,NORDESTE,5757,1299,4458
2406403,LAGOA DE VELHOS,RN,NORDESTE,2462,784,1678
2406502,LAGOA NOVA,RN,NORDESTE,9437,2387,7050
2406601,LAGOA SALGADA,RN,NORDESTE,7377,2069,5308
2406700,LAJES,RN,NORDESTE,6801,1656,5145
2406809,LAJES PINTADAS,RN,NORDESTE,3990,1081,2909
2406908,LUCRÉCIA,RN,NORDESTE,2745,438,2307
2407005,LUÍS GOMES,RN,NORDESTE,5578,671,4907
2407104,MACAÍBA,RN,NORDESTE,42204,15201,27003
2407203,MACAU,RN,NORDESTE,16856,3697,13159
2407252,MAJOR SALES,RN,NORDESTE,2460,394,2066
2407302,MARCELINO VIEIRA,RN,NORDESTE,5459,705,4754
2407401,MARTINS,RN,NORDESTE,5522,1258,4264
2407500,MAXARANGUAPE,RN,NORDESTE,7332,2449,4883
2407609,MESSIAS TARGINO,RN,NORDESTE,3591,1063,2528
2407708,MONTANHAS,RN,NORDESTE,7122,1525,5597
2407807,MONTE ALEGRE,RN,NORDESTE,13674,4977,8697
2407906,MONTE DAS GAMELEIRAS,RN,NORDESTE,2121,605,1516
2408003,MOSSORÓ,RN,NORDESTE,150488,55207,95281
2408102,NATAL,RN,NORDESTE,466187,219306,246881
2408201,NÍSIA FLORESTA,RN,NORDESTE,16727,6714,10013
2408300,NOVA CRUZ,RN,NORDESTE,20870,6526,14344
2408409,OLHO-D'ÁGUA DO BORGES,RN,NORDESTE,3392,591,2801
2408508,OURO BRANCO,RN,NORDESTE,3498,895,2603
2408607,PARANÁ,RN,NORDESTE,3086,318,2768
2408706,PARAÚ,RN,NORDESTE,3282,851,2431
2408805,PARAZINHO,RN,NORDESTE,4004,1146,2858
2408904,PARELHAS,RN,NORDESTE,13700,5380,8320
2408953,RIO DO FOGO,RN,NORDESTE,7673,2993,4680
2409100,PASSA E FICA,RN,NORDESTE,7358,2515,4843
2409209,PASSAGEM,RN,NORDESTE,2875,965,1910
2409308,PATU,RN,NORDESTE,7579,1786,5793
2409332,SANTA MARIA,RN,NORDESTE,3568,1002,2566
2409407,PAU DOS FERROS,RN,NORDESTE,16635,3920,12715
2409506,PEDRA GRANDE,RN,NORDESTE,3033,743,2290
2409605,PEDRA PRETA,RN,NORDESTE,2437,704,1733
2409704,PEDRO AVELINO,RN,NORDESTE,4468,1149,3319
2409803,PEDRO VELHO,RN,NORDESTE,9097,2300,6797
2409902,PENDÊNCIAS,RN,NORDESTE,8427,1742,6685
2410009,PILÕES,RN,NORDESTE,2657,318,2339
2410108,POÇO BRANCO,RN,NORDESTE,8756,1658,7098
2410207,PORTALEGRE,RN,NORDESTE,5171,1568,3603
2410256,PORTO DO MANGUE,RN,NORDESTE,3766,739,3027
2410306,SERRA CAIADA,RN,NORDESTE,6678,1942,4736
2410405,PUREZA,RN,NORDESTE,6052,1467,4585
2410504,RAFAEL FERNANDES,RN,NORDESTE,4018,666,3352
2410603,RAFAEL GODEIRO,RN,NORDESTE,2817,1103,1714
2410702,RIACHO DA CRUZ,RN,NORDESTE,2228,563,1665
2410801,RIACHO DE SANTANA,RN,NORDESTE,3045,429,2616
2410900,RIACHUELO,RN,NORDESTE,5191,1441,3750
2411007,RODOLFO FERNANDES,RN,NORDESTE,3342,641,2701
2411056,TIBAU,RN,NORDESTE,5228,1647,3581
2411106,RUY BARBOSA,RN,NORDESTE,3004,1391,1613
2411205,SANTA CRUZ,RN,NORDESTE,20957,6495,14462
2411403,SANTANA DO MATOS,RN,NORDESTE,8572,1729,6843
2411429,SANTANA DO SERIDÓ,RN,NORDESTE,2096,682,1414
2411502,SANTO ANTÔNIO,RN,NORDESTE,14640,3948,10692
2411601,SÃO BENTO DO NORTE,RN,NORDESTE,2865,677,2188
2411700,SÃO BENTO DO TRAIRÍ,RN,NORDESTE,3213,790,2423
2411809,SÃO FERNANDO,RN,NORDESTE,2932,778,2154
2411908,SÃO FRANCISCO DO OESTE,RN,NORDESTE,3179,610,2569
2412005,SÃO GONÇALO DO AMARANTE,RN,NORDESTE,59774,24301,35473
2412104,SÃO JOÃO DO SABUGI,RN,NORDESTE,4286,1010,3276
2412203,SÃO JOSÉ DE MIPIBU,RN,NORDESTE,25763,9504,16259
2412302,SÃO JOSÉ DO CAMPESTRE,RN,NORDESTE,7954,2621,5333
2412401,SÃO JOSÉ DO SERIDÓ,RN,NORDESTE,3650,859,2791
2412500,SÃO MIGUEL,RN,NORDESTE,13327,2338,10989
2412559,SÃO MIGUEL DO GOSTOSO,RN,NORDESTE,7034,2280,4754
2412609,SÃO PAULO DO POTENGI,RN,NORDESTE,11148,4791,6357
2412708,SÃO PEDRO,RN,NORDESTE,4776,1283,3493
2412807,SÃO RAFAEL,RN,NORDESTE,5639,1480,4159
2412906,SÃO TOMÉ,RN,NORDESTE,7198,3085,4113
2413003,SÃO VICENTE,RN,NORDESTE,4073,1160,2913
2413102,SENADOR ELÓI DE SOUZA,RN,NORDESTE,4430,1220,3210
2413201,SENADOR GEORGINO AVELINO,RN,NORDESTE,3110,1053,2057
2413300,SERRA DE SÃO BENTO,RN,NORDESTE,4263,1184,3079
2413359,SERRA DO MEL,RN,NORDESTE,9237,3307,5930
2413409,SERRA NEGRA DO NORTE,RN,NORDESTE,4953,1580,3373
2413508,SERRINHA,RN,NORDESTE,5350,1552,3798
2413557,SERRINHA DOS PINTOS,RN,NORDESTE,3333,522,2811
2413607,SEVERIANO MELO,RN,NORDESTE,5354,1002,4352
2413706,SÍTIO NOVO,RN,NORDESTE,3771,704,3067
2413805,TABOLEIRO GRANDE,RN,NORDESTE,2250,536,1714
2413904,TAIPU,RN,NORDESTE,8098,1712,6386
2414001,TANGARÁ,RN,NORDESTE,9034,2999,6035
2414100,TENENTE ANANIAS,RN,NORDESTE,6025,1351,4674
2414159,TENENTE LAURENTINO CRUZ,RN,NORDESTE,4145,1100,3045
2414209,TIBAU DO SUL,RN,NORDESTE,10000,3440,6560
2414308,TIMBAÚBA DOS BATISTAS,RN,NORDESTE,2090,686,1404
2414407,TOUROS,RN,NORDESTE,20391,7338,13053
2414456,TRIUNFO POTIGUAR,RN,NORDESTE,3138,898,2240
2414506,UMARIZAL,RN,NORDESTE,6756,1298,5458
2414605,UPANEMA,RN,NORDESTE,9366,3503,5863
2414704,VÁRZEA,RN,NORDESTE,3861,1338,2523
2414753,VENHA-VER,RN,NORDESTE,2736,296,2440
2414803,VERA CRUZ,RN,NORDESTE,8150,2582,5568
2414902,VIÇOSA,RN,NORDESTE,1400,273,1127
2415008,VILA FLOR,RN,NORDESTE,2405,581,1824
2500106,ÁGUA BRANCA,PB,NORDESTE,5751,759,4992
2500205,AGUIAR,PB,NORDESTE,3567,621,2946
2500304,ALAGOA GRANDE,PB,NORDESTE,16120,3941,12179
2500403,ALAGOA NOVA,PB,NORDESTE,11980,2721,9259
2500502,ALAGOINHA,PB,NORDESTE,8773,1563,7210
2500536,ALCANTIL,PB,NORDESTE,3812,1417,2395
2500577,ALGODÃO DE JANDAÍRA,PB,NORDESTE,2280,293,1987
2500601,ALHANDRA,PB,NORDESTE,14761,5875,8886
2500700,SÃO JOÃO DO RIO DO PEIXE,PB,NORDESTE,10942,1835,9107
2500734,AMPARO,PB,NORDESTE,2016,235,1781
2500775,APARECIDA,PB,NORDESTE,5445,1249,4196
2500809,ARAÇAGI,PB,NORDESTE,10419,1803,8616
2500908,ARARA,PB,NORDESTE,6358,1445,4913
2501005,ARARUNA,PB,NORDESTE,9785,2480,7305
2501104,AREIA,PB,NORDESTE,13690,3034,10656
2501153,AREIA DE BARAÚNAS,PB,NORDESTE,1621,247,1374
2501203,AREIAL,PB,NORDESTE,4685,1183,3502
2501302,AROEIRAS,PB,NORDESTE,12136,2350,9786
2501351,ASSUNÇÃO,PB,NORDESTE,3045,680,2365
2501401,BAÍA DA TRAIÇÃO,PB,NORDESTE,5734,974,4760
2501500,BANANEIRAS,PB,NORDESTE,13515,2664,10851
2501534,BARAÚNA,PB,NORDESTE,3418,597,2821
2501575,BARRA DE SANTANA,PB,NORDESTE,5726,1458,4268
2501609,BARRA DE SANTA ROSA,PB,NORDESTE,8251,1683,6568
2501708,BARRA DE SÃO MIGUEL,PB,NORDESTE,4671,1253,3418
2501807,BAYEUX,PB,NORDESTE,58882,27977,30905
2501906,BELÉM,PB,NORDESTE,9817,2810,7007
2502003,BELÉM DO BREJO DO CRUZ,PB,NORDESTE,4619,1147,3472
2502052,BERNARDINO BATISTA,PB,NORDESTE,2269,337,1932
2502102,BOA VENTURA,PB,NORDESTE,3689,665,3024
2502151,BOA VISTA,PB,NORDESTE,4877,1523,3354
2502201,BOM JESUS,PB,NORDESTE,2408,268,2140
2502300,BOM SUCESSO,PB,NORDESTE,3543,3124,419
2502409,BONITO DE SANTA FÉ,PB,NORDESTE,5609,1328,4281
2502508,BOQUEIRÃO,PB,NORDESTE,11641,3505,8136
2502607,IGARACY,PB,NORDESTE,3882,735,3147
2502706,BORBOREMA,PB,NORDESTE,3316,673,2643
2502805,BREJO DO CRUZ,PB,NORDESTE,7790,2270,5520
2502904,BREJO DOS SANTOS,PB,NORDESTE,4549,1190,3359
2503001,CAAPORÃ,PB,NORDESTE,12825,4079,8746
2503100,CABACEIRAS,PB,NORDESTE,3958,1254,2704
2503209,CABEDELO,PB,NORDESTE,38629,18523,20106
2503308,CACHOEIRA DOS ÍNDIOS,PB,NORDESTE,5800,796,5004
2503407,CACIMBA DE AREIA,PB,NORDESTE,3074,551,2523
2503506,CACIMBA DE DENTRO,PB,NORDESTE,9916,2348,7568
2503555,CACIMBAS,PB,NORDESTE,4245,578,3667
2503605,CAIÇARA,PB,NORDESTE,4538,1282,3256
2503704,CAJAZEIRAS,PB,NORDESTE,36033,6965,29068
2503753,CAJAZEIRINHAS,PB,NORDESTE,2860,505,2355
2503803,CALDAS BRANDÃO,PB,NORDESTE,4095,965,3130
2503902,CAMALAÚ,PB,NORDESTE,4741,489,4252
2504009,CAMPINA GRANDE,PB,NORDESTE,240527,115859,124668
2504033,CAPIM,PB,NORDESTE,4796,1201,3595
2504074,CARAÚBAS,PB,NORDESTE,3404,679,2725
2504108,CARRAPATEIRA,PB,NORDESTE,1560,218,1342
2504157,CASSERENGUE,PB,NORDESTE,4289,695,3594
2504207,CATINGUEIRA,PB,NORDESTE,3704,891,2813
2504306,CATOLÉ DO ROCHA,PB,NORDESTE,16952,4099,12853
2504355,CATURITÉ,PB,NORDESTE,4000,895,3105
2504405,CONCEIÇÃO,PB,NORDESTE,10669,2183,8486
2504504,CONDADO,PB,NORDESTE,4150,737,3413
2504603,CONDE,PB,NORDESTE,17757,6782,10975
2504702,CONGO,PB,NORDESTE,4107,722,3385
2504801,COREMAS,PB,NORDESTE,8854,1937,6917
2504850,COXIXOLA,PB,NORDESTE,1535,286,1249
2504900,CRUZ DO ESPÍRITO SANTO,PB,NORDESTE,12417,3389,9028
2505006,CUBATI,PB,NORDESTE,5007,1198,3809
2505105,CUITÉ,PB,NORDESTE,12786,2258,10528
2505204,CUITEGI,PB,NORDESTE,4281,972,3309
2505238,CUITÉ DE MAMANGUAPE,PB,NORDESTE,5099,907,4192
2505279,CURRAL DE CIMA,PB,NORDESTE,4140,738,3402
2505303,CURRAL VELHO,PB,NORDESTE,1692,354,1338
2505352,DAMIÃO,PB,NORDESTE,3344,491,2853
2505402,DESTERRO,PB,NORDESTE,5452,1033,4419
2505501,VISTA SERRANA,PB,NORDESTE,2282,526,1756
2505600,DIAMANTE,PB,NORDESTE,3807,684,3123
2505709,DONA INÊS,PB,NORDESTE,6668,949,5719
2505808,DUAS ESTRADAS,PB,NORDESTE,2686,622,2064
2505907,EMAS,PB,NORDESTE,2428,536,1892
2506004,ESPERANÇA,PB,NORDESTE,19225,6033,13192
2506103,FAGUNDES,PB,NORDESTE,7353,1436,5917
2506202,FREI MARTINHO,PB,NORDESTE,2198,562,1636
2506251,GADO BRAVO,PB,NORDESTE,5707,997,4710
2506301,GUARABIRA,PB,NORDESTE,33431,12583,20848
2506400,GURINHÉM,PB,NORDESTE,8524,2035,6489
2506509,GURJÃO,PB,NORDESTE,2440,382,2058
2506608,IBIARA,PB,NORDESTE,3854,563,3291
2506707,IMACULADA,PB,NORDESTE,6263,818,5445
2506806,INGÁ,PB,NORDESTE,11271,3330,7941
2506905,ITABAIANA,PB,NORDESTE,14831,5456,9375
2507002,ITAPORANGA,PB,NORDESTE,12549,2846,9703
2507101,ITAPOROROCA,PB,NORDESTE,10123,2470,7653
2507200,ITATUBA,PB,NORDESTE,6518,1635,4883
2507309,JACARAÚ,PB,NORDESTE,9900,2822,7078
2507408,JERICÓ,PB,NORDESTE,5200,813,4387
2507507,JOÃO PESSOA,PB,NORDESTE,457577,228326,229251
2507606,JUAREZ TÁVORA,PB,NORDESTE,5764,1297,4467
2507705,JUAZEIRINHO,PB,NORDESTE,10050,2362,7688
2507804,JUNCO DO SERIDÓ,PB,NORDESTE,4351,991,3360
2507903,JURIPIRANGA,PB,NORDESTE,7627,2029,5598
2508000,JURU,PB,NORDESTE,5650,732,4918
2508109,LAGOA,PB,NORDESTE,3401,496,2905
2508208,LAGOA DE DENTRO,PB,NORDESTE,5226,1147,4079
2508307,LAGOA SECA,PB,NORDESTE,16219,5965,10254
2508406,LASTRO,PB,NORDESTE,3272,518,2754
2508505,LIVRAMENTO,PB,NORDESTE,4254,957,3297
2508554,LOGRADOURO,PB,NORDESTE,3098,987,2111
2508604,LUCENA,PB,NORDESTE,9169,3106,6063
2508703,MÃE D'ÁGUA,PB,NORDESTE,2934,504,2430
2508802,MALTA,PB,NORDESTE,3847,531,3316
2508901,MAMANGUAPE,PB,NORDESTE,25008,8016,16992
2509008,MANAÍRA,PB,NORDESTE,6391,780,5611
2509057,MARCAÇÃO,PB,NORDESTE,5518,849,4669
2509107,MARI,PB,NORDESTE,13568,3769,9799
2509156,MARIZÓPOLIS,PB,NORDESTE,4818,1288,3530
2509206,MASSARANDUBA,PB,NORDESTE,8934,2454,6480
2509305,MATARACA,PB,NORDESTE,5988,1715,4273
2509339,MATINHAS,PB,NORDESTE,3349,675,2674
2509370,MATO GROSSO,PB,NORDESTE,2150,204,1946
2509396,MATURÉIA,PB,NORDESTE,4016,596,3420
2509404,MOGEIRO,PB,NORDESTE,8153,2452,5701
2509503,MONTADAS,PB,NORDESTE,3873,1065,2808
2509602,MONTE HOREBE,PB,NORDESTE,2866,390,2476
2509701,MONTEIRO,PB,NORDESTE,19926,4177,15749
2509800,MULUNGU,PB,NORDESTE,6917,1608,5309
2509909,NATUBA,PB,NORDESTE,4847,1196,3651
2510006,NAZAREZINHO,PB,NORDESTE,5395,734,4661
2510105,NOVA FLORESTA,PB,NORDESTE,5971,1249,4722
2510204,NOVA OLINDA,PB,NORDESTE,3621,3064,557
2510303,NOVA PALMEIRA,PB,NORDESTE,2795,385,2410
2510402,OLHO D'ÁGUA,PB,NORDESTE,5010,1021,3989
2510501,OLIVEDOS,PB,NORDESTE,3058,783,2275
2510600,OURO VELHO,PB,NORDESTE,2388,444,1944
2510659,PARARI,PB,NORDESTE,1697,328,1369
2510709,PASSAGEM,PB,NORDESTE,1960,436,1524
2510808,PATOS,PB,NORDESTE,51970,17506,34464
2510907,PAULISTA,PB,NORDESTE,7621,1979,5642
2511004,PEDRA BRANCA,PB,NORDESTE,2739,649,2090
2511103,PEDRA LAVRADA,PB,NORDESTE,4719,932,3787
2511202,PEDRAS DE FOGO,PB,NORDESTE,18302,5820,12482
2511301,PIANCÓ,PB,NORDESTE,9380,2379,7001
2511400,PICUÍ,PB,NORDESTE,11653,3060,8593
2511509,PILAR,PB,NORDESTE,7842,2197,5645
2511608,PILÕES,PB,NORDESTE,5002,1076,3926
2511707,PILÕEZINHOS,PB,NORDESTE,4021,733,3288
2511806,PIRPIRITUBA,PB,NORDESTE,5787,1428,4359
2511905,PITIMBU,PB,NORDESTE,9279,2913,6366
2512002,POCINHOS,PB,NORDESTE,10865,3632,7233
2512036,POÇO DANTAS,PB,NORDESTE,2926,341,2585
2512077,POÇO DE JOSÉ DE MOURA,PB,NORDESTE,3020,463,2557
2512101,POMBAL,PB,NORDESTE,18923,6338,12585
2512200,PRATA,PB,NORDESTE,3109,812,2297
2512309,PRINCESA ISABEL,PB,NORDESTE,12063,1877,10186
2512408,PUXINANÃ,PB,NORDESTE,9681,3060,6621
2512507,QUEIMADAS,PB,NORDESTE,27484,7648,19836
2512606,QUIXABA,PB,NORDESTE,1824,506,1318
2512705,REMÍGIO,PB,NORDESTE,10834,2358,8476
2512721,PEDRO RÉGIS,PB,NORDESTE,3752,968,2784
2512747,RIACHÃO,PB,NORDESTE,2436,489,1947
2512754,RIACHÃO DO BACAMARTE,PB,NORDESTE,3413,806,2607
2512762,RIACHÃO DO POÇO,PB,NORDESTE,3484,970,2514
2512788,RIACHO DE SANTO ANTÔNIO,PB,NORDESTE,1938,583,1355
2512804,RIACHO DOS CAVALOS,PB,NORDESTE,6128,1004,5124
2512903,RIO TINTO,PB,NORDESTE,14753,4349,10404
2513000,SALGADINHO,PB,NORDESTE,2280,454,1826
2513109,SALGADO DE SÃO FÉLIX,PB,NORDESTE,7250,1902,5348
2513158,SANTA CECÍLIA,PB,NORDESTE,5522,1302,4220
2513208,SANTA CRUZ,PB,NORDESTE,4435,683,3752
2513307,SANTA HELENA,PB,NORDESTE,4439,511,3928
2513356,SANTA INÊS,PB,NORDESTE,2784,230,2554
2513406,SANTA LUZIA,PB,NORDESTE,9295,2618,6677
2513505,SANTANA DE MANGUEIRA,PB,NORDESTE,3241,346,2895
2513604,SANTANA DOS GARROTES,PB,NORDESTE,4281,950,3331
2513653,JOCA CLAUDINO,PB,NORDESTE,1860,255,1605
2513703,SANTA RITA,PB,NORDESTE,76160,31965,44195
2513802,SANTA TERESINHA,PB,NORDESTE,4365,1072,3293
2513851,SANTO ANDRÉ,PB,NORDESTE,2207,390,1817
2513901,SÃO BENTO,PB,NORDESTE,20510,9122,11388
2513927,SÃO BENTINHO,PB,NORDESTE,2845,422,2423
2513943,SÃO DOMINGOS DO CARIRI,PB,NORDESTE,2208,563,1645
2513968,SÃO DOMINGOS,PB,NORDESTE,2376,1837,539
2513984,SÃO FRANCISCO,PB,NORDESTE,3275,705,2570
2514008,SÃO JOÃO DO CARIRI,PB,NORDESTE,3277,592,2685
2514107,SÃO JOÃO DO TIGRE,PB,NORDESTE,3027,514,2513
2514206,SÃO JOSÉ DA LAGOA TAPADA,PB,NORDESTE,5080,900,4180
2514305,SÃO JOSÉ DE CAIANA,PB,NORDESTE,3661,623,3038
2514404,SÃO JOSÉ DE ESPINHARAS,PB,NORDESTE,3331,667,2664
2514453,SÃO JOSÉ DOS RAMOS,PB,NORDESTE,4167,927,3240
2514503,SÃO JOSÉ DE PIRANHAS,PB,NORDESTE,11431,1817,9614
2514552,SÃO JOSÉ DE PRINCESA,PB,NORDESTE,2415,371,2044
2514602,SÃO JOSÉ DO BONFIM,PB,NORDESTE,3168,786,2382
2514651,SÃO JOSÉ DO BREJO DO CRUZ,PB,NORDESTE,1751,515,1236
2514701,SÃO JOSÉ DO SABUGI,PB,NORDESTE,3398,865,2533
2514800,SÃO JOSÉ DOS CORDEIROS,PB,NORDESTE,2609,444,2165
2514909,SÃO MAMEDE,PB,NORDESTE,5270,1411,3859
2515005,SÃO MIGUEL DE TAIPU,PB,NORDESTE,4791,1923,2868
2515104,SÃO SEBASTIÃO DE LAGOA DE ROÇA,PB,NORDESTE,6580,1897,4683
2515203,SÃO SEBASTIÃO DO UMBUZEIRO,PB,NORDESTE,2411,298,2113
2515302,SAPÉ,PB,NORDESTE,27806,8833,18973
2515401,SÃO VICENTE DO SERIDÓ,PB,NORDESTE,6617,1343,5274
2515500,SERRA BRANCA,PB,NORDESTE,7956,2155,5801
2515609,SERRA DA RAIZ,PB,NORDESTE,2230,584,1646
2515708,SERRA GRANDE,PB,NORDESTE,2256,321,1935
2515807,SERRA REDONDA,PB,NORDESTE,4815,1126,3689
2515906,SERRARIA,PB,NORDESTE,3084,742,2342
2515930,SERTÃOZINHO,PB,NORDESTE,3352,721,2631
2515971,SOBRADO,PB,NORDESTE,5645,1577,4068
2516003,SOLÂNEA,PB,NORDESTE,15942,4326,11616
2516102,SOLEDADE,PB,NORDESTE,8647,2415,6232
2516151,SOSSÊGO,PB,NORDESTE,2606,379,2227
2516201,SOUSA,PB,NORDESTE,37317,10562,26755
2516300,SUMÉ,PB,NORDESTE,10439,2039,8400
2516409,TACIMA,PB,NORDESTE,5666,1314,4352
2516508,TAPEROÁ,PB,NORDESTE,7863,1560,6303
2516607,TAVARES,PB,NORDESTE,8145,929,7216
2516706,TEIXEIRA,PB,NORDESTE,8921,1617,7304
2516755,TENÓRIO,PB,NORDESTE,2222,394,1828
2516805,TRIUNFO,PB,NORDESTE,5564,664,4900
2516904,UIRAÚNA,PB,NORDESTE,9345,1821,7524
2517001,UMBUZEIRO,PB,NORDESTE,5198,1098,4100
2517100,VÁRZEA,PB,NORDESTE,2105,340,1765
2517209,VIEIRÓPOLIS,PB,NORDESTE,3754,663,3091
2517407,ZABELÊ,PB,NORDESTE,1770,241,1529
2600054,ABREU E LIMA,PE,NORDESTE,65420,27008,38412
2600104,AFOGADOS DA INGAZEIRA,PE,NORDESTE,21611,4776,16835
2600203,AFRÂNIO,PE,NORDESTE,12942,2885,10057
2600302,AGRESTINA,PE,NORDESTE,15561,3659,11902
2600401,ÁGUA PRETA,PE,NORDESTE,14662,3720,10942
2600500,ÁGUAS BELAS,PE,NORDESTE,22599,4837,17762
2600609,ALAGOINHA,PE,NORDESTE,9502,1138,8364
2600708,ALIANÇA,PE,NORDESTE,20908,5979,14929
2600807,ALTINHO,PE,NORDESTE,12962,2992,9970
2600906,AMARAJI,PE,NORDESTE,12666,3949,8717
2601003,ANGELIM,PE,NORDESTE,6687,1460,5227
2601052,ARAÇOIABA,PE,NORDESTE,13021,3863,9158
2601102,ARARIPINA,PE,NORDESTE,43416,9004,34412
2601201,ARCOVERDE,PE,NORDESTE,38326,9790,28536
2601300,BARRA DE GUABIRABA,PE,NORDESTE,7721,2800,4921
2601409,BARREIROS,PE,NORDESTE,22072,7814,14258
2601508,BELÉM DE MARIA,PE,NORDESTE,7040,1792,5248
2601607,BELÉM DO SÃO FRANCISCO,PE,NORDESTE,11383,1774,9609
2601706,BELO JARDIM,PE,NORDESTE,45650,13602,32048
2601805,BETÂNIA,PE,NORDESTE,6747,759,5988
2601904,BEZERROS,PE,NORDESTE,37147,10289,26858
2602001,BODOCÓ,PE,NORDESTE,19743,2126,17617
2602100,BOM CONSELHO,PE,NORDESTE,24535,4876,19659
2602209,BOM JARDIM,PE,NORDESTE,22585,17305,5280
2602308,BONITO,PE,NORDESTE,23172,7600,15572
2602407,BREJÃO,PE,NORDESTE,6985,1258,5727
2602506,BREJINHO,PE,NORDESTE,5489,817,4672
2602605,BREJO DA MADRE DE DEUS,PE,NORDESTE,25125,7781,17344
2602704,BUENOS AIRES,PE,NORDESTE,8755,1999,6756
2602803,BUÍQUE,PE,NORDESTE,26293,3394,22899
2602902,CABO DE SANTO AGOSTINHO,PE,NORDESTE,127209,40592,86617
2603009,CABROBÓ,PE,NORDESTE,19001,3196,15805
2603108,CACHOEIRINHA,PE,NORDESTE,12034,2911,9123
2603207,CAETÉS,PE,NORDESTE,13949,1281,12668
2603306,CALÇADO,PE,NORDESTE,5914,724,5190
2603405,CALUMBI,PE,NORDESTE,5039,583,4456
2603454,CAMARAGIBE,PE,NORDESTE,99150,43186,55964
2603504,CAMOCIM DE SÃO FÉLIX,PE,NORDESTE,11809,3155,8654
2603603,CAMUTANGA,PE,NORDESTE,5614,1597,4017
2603702,CANHOTINHO,PE,NORDESTE,12520,3499,9021
2603801,CAPOEIRAS,PE,NORDESTE,11185,1322,9863
2603900,CARNAÍBA,PE,NORDESTE,11682,1535,10147
2603926,CARNAUBEIRA DA PENHA,PE,NORDESTE,8608,663,7945
2604007,CARPINA,PE,NORDESTE,46025,20237,25788
2604106,CARUARU,PE,NORDESTE,196200,83013,113187
2604155,CASINHAS,PE,NORDESTE,8720,1590,7130
2604205,CATENDE,PE,NORDESTE,18466,4947,13519
2604304,CEDRO,PE,NORDESTE,6755,799,5956
2604403,CHÃ DE ALEGRIA,PE,NORDESTE,8703,2505,6198
2604502,CHÃ GRANDE,PE,NORDESTE,14833,4695,10138
2604601,CONDADO,PE,NORDESTE,15209,4414,10795
2604700,CORRENTES,PE,NORDESTE,9270,1369,7901
2604809,CORTÊS,PE,NORDESTE,7908,2158,5750
2604908,CUMARU,PE,NORDESTE,11041,2524,8517
2605004,CUPIRA,PE,NORDESTE,14955,5142,9813
2605103,CUSTÓDIA,PE,NORDESTE,20577,2589,17988
2605152,DORMENTES,PE,NORDESTE,12388,2610,9778
2605202,ESCADA,PE,NORDESTE,36985,10999,25986
2605301,EXU,PE,NORDESTE,20471,2591,17880
2605400,FEIRA NOVA,PE,NORDESTE,13847,4785,9062
2605459,FERNANDO DE NORONHA,PE,NORDESTE,1990,922,1068
2605509,FERREIROS,PE,NORDESTE,7704,2105,5599
2605608,FLORES,PE,NORDESTE,11962,1565,10397
2605707,FLORESTA,PE,NORDESTE,17670,2519,15151
2605806,FREI MIGUELINHO,PE,NORDESTE,9843,2662,7181
2605905,GAMELEIRA,PE,NORDESTE,10992,3379,7613
2606002,GARANHUNS,PE,NORDESTE,75167,19731,55436
2606101,GLÓRIA DO GOITÁ,PE,NORDESTE,17718,4353,13365
2606200,GOIANA,PE,NORDESTE,49381,17502,31879
2606309,GRANITO,PE,NORDESTE,5396,707,4689
2606408,GRAVATÁ,PE,NORDESTE,52096,19063,33033
2606507,IATI,PE,NORDESTE,10476,1439,9037
2606606,IBIMIRIM,PE,NORDESTE,14593,1624,12969
2606705,IBIRAJUBA,PE,NORDESTE,5140,964,4176
2606804,IGARASSU,PE,NORDESTE,68504,23927,44577
2606903,IGUARACI,PE,NORDESTE,6683,945,5738
2607000,INAJÁ,PE,NORDESTE,10523,1021,9502
2607109,INGAZEIRA,PE,NORDESTE,3260,401,2859
2607208,IPOJUCA,PE,NORDESTE,63006,17518,45488
2607307,IPUBI,PE,NORDESTE,15987,2692,13295
2607406,ITACURUBA,PE,NORDESTE,3241,412,2829
2607505,ITAÍBA,PE,NORDESTE,13828,2199,11629
2607604,ILHA DE ITAMARACÁ,PE,NORDESTE,13419,3719,9700
2607653,ITAMBÉ,PE,NORDESTE,18331,13209,5122
2607703,ITAPETIM,PE,NORDESTE,8994,1594,7400
2607752,ITAPISSUMA,PE,NORDESTE,15276,4271,11005
2607802,ITAQUITINGA,PE,NORDESTE,10037,3170,6867
2607901,JABOATÃO DOS GUARARAPES,PE,NORDESTE,365964,161952,204012
2607950,JAQUEIRA,PE,NORDESTE,6658,1697,4961
2608008,JATAÚBA,PE,NORDESTE,10868,2083,8785
2608057,JATOBÁ,PE,NORDESTE,7951,1156,6795
2608107,JOÃO ALFREDO,PE,NORDESTE,17928,3582,14346
2608206,JOAQUIM NABUCO,PE,NORDESTE,10038,2886,7152
2608255,JUCATI,PE,NORDESTE,7599,1095,6504
2608305,JUPI,PE,NORDESTE,9499,1496,8003
2608404,JUREMA,PE,NORDESTE,8571,1788,6783
2608453,LAGOA DO CARRO,PE,NORDESTE,11844,3505,8339
2608503,LAGOA DE ITAENGA,PE,NORDESTE,13964,4474,9490
2608602,LAGOA DO OURO,PE,NORDESTE,7957,1179,6778
2608701,LAGOA DOS GATOS,PE,NORDESTE,8572,1751,6821
2608750,LAGOA GRANDE,PE,NORDESTE,15283,3006,12277
2608800,LAJEDO,PE,NORDESTE,23519,7009,16510
2608909,LIMOEIRO,PE,NORDESTE,35324,9856,25468
2609006,MACAPARANA,PE,NORDESTE,14216,4692,9524
2609105,MACHADOS,PE,NORDESTE,8117,1847,6270
2609154,MANARI,PE,NORDESTE,9208,978,8230
2609204,MARAIAL,PE,NORDESTE,5679,1639,4040
2609303,MIRANDIBA,PE,NORDESTE,8460,1556,6904
2609402,MORENO,PE,NORDESTE,37424,13064,24360
2609501,NAZARÉ DA MATA,PE,NORDESTE,20168,7418,12750
2609600,OLINDA,PE,NORDESTE,246248,101401,144847
2609709,OROBÓ,PE,NORDESTE,13620,2679,10941
2609808,OROCÓ,PE,NORDESTE,9011,1708,7303
2609907,OURICURI,PE,NORDESTE,35487,5018,30469
2610004,PALMARES,PE,NORDESTE,30232,9121,21111
2610103,PALMEIRINA,PE,NORDESTE,4181,674,3507
2610202,PANELAS,PE,NORDESTE,14423,3306,11117
2610301,PARANATAMA,PE,NORDESTE,8234,1159,7075
2610400,PARNAMIRIM,PE,NORDESTE,13769,1301,12468
2610509,PASSIRA,PE,NORDESTE,19531,4785,14746
2610608,PAUDALHO,PE,NORDESTE,34951,13715,21236
2610707,PAULISTA,PE,NORDESTE,186826,77951,108875
2610806,PEDRA,PE,NORDESTE,13846,2312,11534
2610905,PESQUEIRA,PE,NORDESTE,35721,6157,29564
2611002,PETROLÂNDIA,PE,NORDESTE,18458,3493,14965
2611101,PETROLINA,PE,NORDESTE,182753,59182,123571
2611200,POÇÃO,PE,NORDESTE,7366,1134,6232
2611309,POMBOS,PE,NORDESTE,15830,5403,10427
2611408,PRIMAVERA,PE,NORDESTE,8203,2285,5918
2611507,QUIPAPÁ,PE,NORDESTE,10788,1967,8821
2611533,QUIXABÁ,PE,NORDESTE,4811,471,4340
2611606,RECIFE,PE,NORDESTE,992007,433317,558690
2611705,RIACHO DAS ALMAS,PE,NORDESTE,16297,4576,11721
2611804,RIBEIRÃO,PE,NORDESTE,21045,6397,14648
2611903,RIO FORMOSO,PE,NORDESTE,12024,3401,8623
2612000,SAIRÉ,PE,NORDESTE,8875,2567,6308
2612109,SALGADINHO,PE,NORDESTE,5092,1171,3921
2612208,SALGUEIRO,PE,NORDESTE,32578,6288,26290
2612307,SALOÁ,PE,NORDESTE,8802,1017,7785
2612406,SANHARÓ,PE,NORDESTE,12245,2497,9748
2612455,SANTA CRUZ,PE,NORDESTE,9819,8645,1174
2612471,SANTA CRUZ DA BAIXA VERDE,PE,NORDESTE,7219,1068,6151
2612505,SANTA CRUZ DO CAPIBARIBE,PE,NORDESTE,51094,26632,24462
2612554,SANTA FILOMENA,PE,NORDESTE,9131,1099,8032
2612604,SANTA MARIA DA BOA VISTA,PE,NORDESTE,22714,3911,18803
2612703,SANTA MARIA DO CAMBUCÁ,PE,NORDESTE,8551,2416,6135
2612802,SANTA TEREZINHA,PE,NORDESTE,6012,5042,970
2612901,SÃO BENEDITO DO SUL,PE,NORDESTE,5387,1138,4249
2613008,SÃO BENTO DO UNA,PE,NORDESTE,26280,6466,19814
2613107,SÃO CAITANO,PE,NORDESTE,23729,5241,18488
2613206,SÃO JOÃO,PE,NORDESTE,13578,1872,11706
2613305,SÃO JOAQUIM DO MONTE,PE,NORDESTE,13059,3433,9626
2613404,SÃO JOSÉ DA COROA GRANDE,PE,NORDESTE,11238,4714,6524
2613503,SÃO JOSÉ DO BELMONTE,PE,NORDESTE,19304,2443,16861
2613602,SÃO JOSÉ DO EGITO,PE,NORDESTE,17690,3583,14107
2613701,SÃO LOURENÇO DA MATA,PE,NORDESTE,63800,24022,39778
2613800,SÃO VICENTE FERRER,PE,NORDESTE,10639,2540,8099
2613909,SERRA TALHADA,PE,NORDESTE,46459,10506,35953
2614006,SERRITA,PE,NORDESTE,11422,1202,10220
2614105,SERTÂNIA,PE,NORDESTE,18034,2573,15461
2614204,SIRINHAÉM,PE,NORDESTE,21112,6982,14130
2614303,MOREILÂNDIA,PE,NORDESTE,7266,818,6448
2614402,SOLIDÃO,PE,NORDESTE,4244,492,3752
2614501,SURUBIM,PE,NORDESTE,36568,11284,25284
2614600,TABIRA,PE,NORDESTE,15956,2707,13249
2614709,TACAIMBÓ,PE,NORDESTE,7795,1771,6024
2614808,TACARATU,PE,NORDESTE,12803,1602,11201
2614857,TAMANDARÉ,PE,NORDESTE,14012,4648,9364
2615003,TAQUARITINGA DO NORTE,PE,NORDESTE,16719,7129,9590
2615102,TEREZINHA,PE,NORDESTE,4756,782,3974
2615201,TERRA NOVA,PE,NORDESTE,6631,509,6122
2615300,TIMBAÚBA,PE,NORDESTE,32058,10388,21670
2615409,TORITAMA,PE,NORDESTE,26317,11702,14615
2615508,TRACUNHAÉM,PE,NORDESTE,8917,2653,6264
2615607,TRINDADE,PE,NORDESTE,16486,4083,12403
2615706,TRIUNFO,PE,NORDESTE,8950,7552,1398
2615805,TUPANATINGA,PE,NORDESTE,11656,1869,9787
2615904,TUPARETAMA,PE,NORDESTE,6288,864,5424
2616001,VENTUROSA,PE,NORDESTE,10805,1897,8908
2616100,VERDEJANTE,PE,NORDESTE,5971,685,5286
2616183,VERTENTE DO LÉRIO,PE,NORDESTE,5918,1130,4788
2616209,VERTENTES,PE,NORDESTE,12625,3718,8907
2616308,VICÊNCIA,PE,NORDESTE,16250,5245,11005
2616407,VITÓRIA DE SANTO ANTÃO,PE,NORDESTE,81203,33410,47793
2616506,XEXÉU,PE,NORDESTE,7226,2143,5083
2700102,ÁGUA BRANCA,AL,NORDESTE,10404,9400,1004
2700201,ANADIA,AL,NORDESTE,8185,2019,6166
2700300,ARAPIRACA,AL,NORDESTE,115683,54674,61009
2700409,ATALAIA,AL,NORDESTE,20884,7544,13340
2700508,BARRA DE SANTO ANTÔNIO,AL,NORDESTE,8741,3586,5155
2700607,BARRA DE SÃO MIGUEL,AL,NORDESTE,5570,2871,2699
2700706,BATALHA,AL,NORDESTE,9375,2982,6393
2700805,BELÉM,AL,NORDESTE,3292,886,2406
2700904,BELO MONTE,AL,NORDESTE,4170,1057,3113
2701001,BOCA DA MATA,AL,NORDESTE,13083,5359,7724
2701100,BRANQUINHA,AL,NORDESTE,5612,1571,4041
2701209,CACIMBINHAS,AL,NORDESTE,5587,1440,4147
2701308,CAJUEIRO,AL,NORDESTE,9407,2991,6416
2701357,CAMPESTRE,AL,NORDESTE,3784,1089,2695
2701407,CAMPO ALEGRE,AL,NORDESTE,17498,6012,11486
2701506,CAMPO GRANDE,AL,NORDESTE,6245,1197,5048
2701605,CANAPI,AL,NORDESTE,8838,1365,7473
2701704,CAPELA,AL,NORDESTE,8751,3523,5228
2701803,CARNEIROS,AL,NORDESTE,4698,810,3888
2701902,CHÃ PRETA,AL,NORDESTE,4089,963,3126
2702009,COITÉ DO NÓIA,AL,NORDESTE,6411,1378,5033
2702108,COLÔNIA LEOPOLDINA,AL,NORDESTE,9652,4366,5286
2702207,COQUEIRO SECO,AL,NORDESTE,3716,1446,2270
2702306,CORURIPE,AL,NORDESTE,27172,14497,12675
2702355,CRAÍBAS,AL,NORDESTE,14556,3062,11494
2702405,DELMIRO GOUVEIA,AL,NORDESTE,27738,5050,22688
2702504,DOIS RIACHOS,AL,NORDESTE,6165,1460,4705
2702553,ESTRELA DE ALAGOAS,AL,NORDESTE,7575,1201,6374
2702603,FEIRA GRANDE,AL,NORDESTE,13313,2967,10346
2702702,FELIZ DESERTO,AL,NORDESTE,2287,690,1597
2702801,FLEXEIRAS,AL,NORDESTE,5636,2841,2795
2702900,GIRAU DO PONCIANO,AL,NORDESTE,19255,3511,15744
2703007,IBATEGUARA,AL,NORDESTE,7677,2761,4916
2703106,IGACI,AL,NORDESTE,13464,2627,10837
2703205,IGREJA NOVA,AL,NORDESTE,12538,2944,9594
2703304,INHAPI,AL,NORDESTE,8615,1387,7228
2703403,JACARÉ DOS HOMENS,AL,NORDESTE,3439,651,2788
2703502,JACUÍPE,AL,NORDESTE,3772,1050,2722
2703601,JAPARATINGA,AL,NORDESTE,5066,2766,2300
2703700,JARAMATAIA,AL,NORDESTE,3562,760,2802
2703759,JEQUIÁ DA PRAIA,AL,NORDESTE,5686,2854,2832
2703809,JOAQUIM GOMES,AL,NORDESTE,9506,2751,6755
2703908,JUNDIÁ,AL,NORDESTE,2766,1010,1756
2704005,JUNQUEIRO,AL,NORDESTE,13730,4665,9065
2704104,LAGOA DA CANOA,AL,NORDESTE,11278,3278,8000
2704203,LIMOEIRO DE ANADIA,AL,NORDESTE,13819,3331,10488
2704302,MACEIÓ,AL,NORDESTE,478436,273549,204887
2704401,MAJOR ISIDORO,AL,NORDESTE,10467,3361,7106
2704500,MARAGOGI,AL,NORDESTE,16375,9451,6924
2704609,MARAVILHA,AL,NORDESTE,5448,1122,4326
2704708,MARECHAL DEODORO,AL,NORDESTE,29827,16560,13267
2704807,MARIBONDO,AL,NORDESTE,7195,2425,4770
2704906,MAR VERMELHO,AL,NORDESTE,2623,752,1871
2705002,MATA GRANDE,AL,NORDESTE,11227,1976,9251
2705101,MATRIZ DE CAMARAGIBE,AL,NORDESTE,12418,6803,5615
2705200,MESSIAS,AL,NORDESTE,9478,3936,5542
2705309,MINADOR DO NEGRÃO,AL,NORDESTE,3369,880,2489
2705408,MONTEIRÓPOLIS,AL,NORDESTE,3986,900,3086
2705507,MURICI,AL,NORDESTE,13029,4827,8202
2705606,NOVO LINO,AL,NORDESTE,6132,3067,3065
2705705,OLHO D'ÁGUA DAS FLORES,AL,NORDESTE,11138,3906,7232
2705804,OLHO D'ÁGUA DO CASADO,AL,NORDESTE,5150,597,4553
2705903,OLHO D'ÁGUA GRANDE,AL,NORDESTE,3194,557,2637
2706000,OLIVENÇA,AL,NORDESTE,6749,1675,5074
2706109,OURO BRANCO,AL,NORDESTE,6809,1416,5393
2706208,PALESTINA,AL,NORDESTE,3012,658,2354
2706307,PALMEIRA DOS ÍNDIOS,AL,NORDESTE,37337,13468,23869
2706406,PÃO DE AÇÚCAR,AL,NORDESTE,12622,2966,9656
2706422,PARICONHA,AL,NORDESTE,6333,562,5771
2706448,PARIPUEIRA,AL,NORDESTE,7929,4187,3742
2706505,PASSO DE CAMARAGIBE,AL,NORDESTE,8404,3388,5016
2706604,PAULO JACINTO,AL,NORDESTE,4306,1247,3059
2706703,PENEDO,AL,NORDESTE,29067,10513,18554
2706802,PIAÇABUÇU,AL,NORDESTE,9144,3013,6131
2706901,PILAR,AL,NORDESTE,19765,8763,11002
2707008,PINDOBA,AL,NORDESTE,1855,594,1261
2707107,PIRANHAS,AL,NORDESTE,13124,1990,11134
2707206,POÇO DAS TRINCHEIRAS,AL,NORDESTE,7329,1027,6302
2707305,PORTO CALVO,AL,NORDESTE,13893,7277,6616
2707404,PORTO DE PEDRAS,AL,NORDESTE,4962,2237,2725
2707503,PORTO REAL DO COLÉGIO,AL,NORDESTE,11616,2405,9211
2707602,QUEBRANGULO,AL,NORDESTE,6906,1733,5173
2707701,RIO LARGO,AL,NORDESTE,46210,22173,24037
2707800,ROTEIRO,AL,NORDESTE,3712,1462,2250
2707909,SANTA LUZIA DO NORTE,AL,NORDESTE,4612,1753,2859
2708006,SANTANA DO IPANEMA,AL,NORDESTE,23084,6028,17056
2708105,SANTANA DO MUNDAÚ,AL,NORDESTE,6281,1438,4843
2708204,SÃO BRÁS,AL,NORDESTE,4689,1211,3478
2708303,SÃO JOSÉ DA LAJE,AL,NORDESTE,11855,4825,7030
2708402,SÃO JOSÉ DA TAPERA,AL,NORDESTE,14152,2721,11431
2708501,SÃO LUÍS DO QUITUNDE,AL,NORDESTE,15558,7169,8389
2708600,SÃO MIGUEL DOS CAMPOS,AL,NORDESTE,30373,14924,15449
2708709,SÃO MIGUEL DOS MILAGRES,AL,NORDESTE,5095,2447,2648
2708808,SÃO SEBASTIÃO,AL,NORDESTE,18313,4612,13701
2708907,SATUBA,AL,NORDESTE,9619,4973,4646
2708956,SENADOR RUI PALMEIRA,AL,NORDESTE,6283,1001,5282
2709004,TANQUE D'ARCA,AL,NORDESTE,3662,609,3053
2709103,TAQUARANA,AL,NORDESTE,9929,2178,7751
2709152,TEOTÔNIO VILELA,AL,NORDESTE,19966,7062,12904
2709202,TRAIPU,AL,NORDESTE,12305,2371,9934
2709301,UNIÃO DOS PALMARES,AL,NORDESTE,31819,11875,19944
2709400,VIÇOSA,AL,NORDESTE,14197,4960,9237
2800100,AMPARO DE SÃO FRANCISCO,SE,NORDESTE,2004,559,1445
2800209,AQUIDABÃ,SE,NORDESTE,12354,2861,9493
2800308,ARACAJU,SE,NORDESTE,333364,142489,190875
2800407,ARAUÁ,SE,NORDESTE,7062,1481,5581
2800506,AREIA BRANCA,SE,NORDESTE,10972,3106,7866
2800605,BARRA DOS COQUEIROS,SE,NORDESTE,18783,7148,11635
2800670,BOQUIM,SE,NORDESTE,16003,4517,11486
2800704,BREJO GRANDE,SE,NORDESTE,5147,1070,4077
2801009,CAMPO DO BRITO,SE,NORDESTE,11298,2777,8521
2801108,CANHOBA,SE,NORDESTE,3328,671,2657
2801207,CANINDÉ DE SÃO FRANCISCO,SE,NORDESTE,16747,3652,13095
2801306,CAPELA,SE,NORDESTE,18676,5492,13184
2801405,CARIRA,SE,NORDESTE,12554,3278,9276
2801504,CARMÓPOLIS,SE,NORDESTE,9251,3012,6239
2801603,CEDRO DE SÃO JOÃO,SE,NORDESTE,4263,1353,2910
2801702,CRISTINÁPOLIS,SE,NORDESTE,10280,2024,8256
2801900,CUMBE,SE,NORDESTE,3342,1197,2145
2802007,DIVINA PASTORA,SE,NORDESTE,3028,632,2396
2802106,ESTÂNCIA,SE,NORDESTE,36750,9847,26903
2802205,FEIRA NOVA,SE,NORDESTE,4513,1008,3505
2802304,FREI PAULO,SE,NORDESTE,10167,3845,6322
2802403,GARARU,SE,NORDESTE,7190,1140,6050
2802502,GENERAL MAYNARD,SE,NORDESTE,2185,539,1646
2802601,GRACHO CARDOSO,SE,NORDESTE,4860,900,3960
2802700,ILHA DAS FLORES,SE,NORDESTE,5021,1111,3910
2802809,INDIAROBA,SE,NORDESTE,9402,1756,7646
2802908,ITABAIANA,SE,NORDESTE,56993,21361,35632
2803005,ITABAIANINHA,SE,NORDESTE,24473,8720,15753
2803104,ITABI,SE,NORDESTE,3458,893,2565
2803203,ITAPORANGA D'AJUDA,SE,NORDESTE,20907,6130,14777
2803302,JAPARATUBA,SE,NORDESTE,10482,2559,7923
2803401,JAPOATÃ,SE,NORDESTE,8289,1949,6340
2803500,LAGARTO,SE,NORDESTE,61177,17841,43336
2803609,LARANJEIRAS,SE,NORDESTE,16403,5418,10985
2803708,MACAMBIRA,SE,NORDESTE,5099,1430,3669
2803807,MALHADA DOS BOIS,SE,NORDESTE,2945,676,2269
2803906,MALHADOR,SE,NORDESTE,7828,1995,5833
2804003,MARUIM,SE,NORDESTE,9612,2120,7492
2804102,MOITA BONITA,SE,NORDESTE,7108,2357,4751
2804201,MONTE ALEGRE DE SERGIPE,SE,NORDESTE,8966,2296,6670
2804300,MURIBECA,SE,NORDESTE,5347,1448,3899
2804409,NEÓPOLIS,SE,NORDESTE,9978,2471,7507
2804458,NOSSA SENHORA APARECIDA,SE,NORDESTE,5797,1951,3846
2804508,NOSSA SENHORA DA GLÓRIA,SE,NORDESTE,22468,5011,17457
2804607,NOSSA SENHORA DAS DORES,SE,NORDESTE,15976,5674,10302
2804706,NOSSA SENHORA DE LOURDES,SE,NORDESTE,4524,889,3635
2804805,NOSSA SENHORA DO SOCORRO,SE,NORDESTE,89961,37770,52191
2804904,PACATUBA,SE,NORDESTE,8004,1438,6566
2805000,PEDRA MOLE,SE,NORDESTE,2503,668,1835
2805109,PEDRINHAS,SE,NORDESTE,5444,1420,4024
2805208,PINHÃO,SE,NORDESTE,4149,874,3275
2805307,PIRAMBU,SE,NORDESTE,5888,1638,4250
2805406,POÇO REDONDO,SE,NORDESTE,15590,3457,12133
2805505,POÇO VERDE,SE,NORDESTE,14421,3174,11247
2805604,PORTO DA FOLHA,SE,NORDESTE,17513,3695,13818
2805703,PROPRIÁ,SE,NORDESTE,15116,5377,9739
2805802,RIACHÃO DO DANTAS,SE,NORDESTE,13395,2458,10937
2805901,RIACHUELO,SE,NORDESTE,6095,1527,4568
2806008,RIBEIRÓPOLIS,SE,NORDESTE,11135,3367,7768
2806107,ROSÁRIO DO CATETE,SE,NORDESTE,6352,1544,4808
2806206,SALGADO,SE,NORDESTE,13186,2847,10339
2806305,SANTA LUZIA DO ITANHY,SE,NORDESTE,7960,1534,6426
2806404,SANTANA DO SÃO FRANCISCO,SE,NORDESTE,4326,1138,3188
2806503,SANTA ROSA DE LIMA,SE,NORDESTE,3150,840,2310
2806602,SANTO AMARO DAS BROTAS,SE,NORDESTE,6898,1180,5718
2806701,SÃO CRISTÓVÃO,SE,NORDESTE,46222,16454,29768
2806800,SÃO DOMINGOS,SE,NORDESTE,6015,1885,4130
2806909,SÃO FRANCISCO,SE,NORDESTE,2717,680,2037
2807006,SÃO MIGUEL DO ALEIXO,SE,NORDESTE,2974,701,2273
2807105,SIMÃO DIAS,SE,NORDESTE,27486,6696,20790
2807204,SIRIRI,SE,NORDESTE,5098,1243,3855
2807303,TELHA,SE,NORDESTE,2825,900,1925
2807402,TOBIAS BARRETO,SE,NORDESTE,32116,9726,22390
2807501,TOMAR DO GERU,SE,NORDESTE,7079,2086,4993
2807600,UMBAÚBA,SE,NORDESTE,14045,4115,9930
2900108,ABAÍRA,BA,NORDESTE,5118,1836,3282
2900207,ABARÉ,BA,NORDESTE,11522,2586,8936
2900306,ACAJUTIBA,BA,NORDESTE,8600,1788,6812
2900355,ADUSTINA,BA,NORDESTE,9256,1562,7694
2900405,ÁGUA FRIA,BA,NORDESTE,8971,1610,7361
2900504,ÉRICO CARDOSO,BA,NORDESTE,6090,1175,4915
2900603,AIQUARA,BA,NORDESTE,2973,719,2254
2900702,ALAGOINHAS,BA,NORDESTE,85224,26077,59147
2900801,ALCOBAÇA,BA,NORDESTE,12692,3706,8986
2900900,ALMADINA,BA,NORDESTE,3467,700,2767
2901007,AMARGOSA,BA,NORDESTE,21433,6678,14755
2901106,AMÉLIA RODRIGUES,BA,NORDESTE,14797,2919,11878
2901155,AMÉRICA DOURADA,BA,NORDESTE,9850,1547,8303
2901205,ANAGÉ,BA,NORDESTE,14081,2977,11104
2901304,ANDARAÍ,BA,NORDESTE,7424,1001,6423
2901353,ANDORINHA,BA,NORDESTE,9892,963,8929
2901403,ANGICAL,BA,NORDESTE,9824,2096,7728
2901502,ANGUERA,BA,NORDESTE,7090,1127,5963
2901601,ANTAS,BA,NORDESTE,8173,2491,5682
2901700,ANTÔNIO CARDOSO,BA,NORDESTE,9171,947,8224
2901809,ANTÔNIO GONÇALVES,BA,NORDESTE,6485,1441,5044
2901908,APORÁ,BA,NORDESTE,9960,2069,7891
2901957,APUAREMA,BA,NORDESTE,4468,1212,3256
2902005,ARACATU,BA,NORDESTE,9826,1958,7868
2902054,ARAÇAS,BA,NORDESTE,7729,1527,6202
2902104,ARACI,BA,NORDESTE,28585,4206,24379
2902203,ARAMARI,BA,NORDESTE,6930,1008,5922
2902252,ARATACA,BA,NORDESTE,4224,1236,2988
2902302,ARATUÍPE,BA,NORDESTE,6311,1170,5141
2902401,AURELINO LEAL,BA,NORDESTE,6839,1725,5114
2902500,BAIANÓPOLIS,BA,NORDESTE,9187,2336,6851
2902609,BAIXA GRANDE,BA,NORDESTE,10787,3064,7723
2902658,BANZAÊ,BA,NORDESTE,7933,1701,6232
2902708,BARRA,BA,NORDESTE,26516,4713,21803
2902807,BARRA DA ESTIVA,BA,NORDESTE,15995,3910,12085
2902906,BARRA DO CHOÇA,BA,NORDESTE,21264,4459,16805
2903003,BARRA DO MENDES,BA,NORDESTE,9528,943,8585
2903102,BARRA DO ROCHA,BA,NORDESTE,2937,963,1974
2903201,BARREIRAS,BA,NORDESTE,84180,34122,50058
2903235,BARRO ALTO,BA,NORDESTE,8456,1499,6957
2903276,BARROCAS,BA,NORDESTE,10741,1651,9090
2903300,BARRO PRETO,BA,NORDESTE,4175,1090,3085
2903409,BELMONTE,BA,NORDESTE,10928,3247,7681
2903508,BELO CAMPO,BA,NORDESTE,11717,2704,9013
2903607,BIRITINGA,BA,NORDESTE,9324,1168,8156
2903706,BOA NOVA,BA,NORDESTE,8587,1173,7414
2903805,BOA VISTA DO TUPIM,BA,NORDESTE,10295,2843,7452
2903904,BOM JESUS DA LAPA,BA,NORDESTE,36761,8045,28716
2903953,BOM JESUS DA SERRA,BA,NORDESTE,6463,773,5690
2904001,BONINAL,BA,NORDESTE,7802,2168,5634
2904050,BONITO,BA,NORDESTE,9290,1572,7718
2904100,BOQUIRA,BA,NORDESTE,12176,1022,11154
2904209,BOTUPORÃ,BA,NORDESTE,6926,1136,5790
2904308,BREJÕES,BA,NORDESTE,7871,2012,5859
2904407,BREJOLÂNDIA,BA,NORDESTE,5873,1583,4290
2904506,BROTAS DE MACAÚBAS,BA,NORDESTE,6941,1536,5405
2904605,BRUMADO,BA,NORDESTE,41434,12589,28845
2904704,BUERAREMA,BA,NORDESTE,8873,5292,3581
2904753,BURITIRAMA,BA,NORDESTE,11099,2326,8773
2904803,CAATIBA,BA,NORDESTE,4400,1353,3047
2904852,CABACEIRAS DO PARAGUAÇU,BA,NORDESTE,10193,1483,8710
2904902,CACHOEIRA,BA,NORDESTE,19329,3197,16132
2905008,CACULÉ,BA,NORDESTE,13777,3890,9887
2905107,CAÉM,BA,NORDESTE,6015,938,5077
2905156,CAETANOS,BA,NORDESTE,7684,821,6863
2905206,CAETITÉ,BA,NORDESTE,33548,6728,26820
2905305,CAFARNAUM,BA,NORDESTE,10919,2694,8225
2905404,CAIRU,BA,NORDESTE,10337,3539,6798
2905503,CALDEIRÃO GRANDE,BA,NORDESTE,7730,1915,5815
2905602,CAMACAN,BA,NORDESTE,12917,5094,7823
2905701,CAMAÇARI,BA,NORDESTE,150367,49304,101063
2905800,CAMAMU,BA,NORDESTE,17017,5685,11332
2905909,CAMPO ALEGRE DE LOURDES,BA,NORDESTE,17457,2701,14756
2906006,CAMPO FORMOSO,BA,NORDESTE,42812,12308,30504
2906105,CANÁPOLIS,BA,NORDESTE,6603,1214,5389
2906204,CANARANA,BA,NORDESTE,15455,3010,12445
2906303,CANAVIEIRAS,BA,NORDESTE,17139,5922,11217
2906402,CANDEAL,BA,NORDESTE,5935,1217,4718
2906501,CANDEIAS,BA,NORDESTE,50504,8957,41547
2906600,CANDIBA,BA,NORDESTE,8657,1905,6752
2906709,CÂNDIDO SALES,BA,NORDESTE,14773,3879,10894
2906808,CANSANÇÃO,BA,NORDESTE,22227,3099,19128
2906824,CANUDOS,BA,NORDESTE,9672,1506,8166
2906857,CAPELA DO ALTO ALEGRE,BA,NORDESTE,6995,1677,5318
2906873,CAPIM GROSSO,BA,NORDESTE,18014,6067,11947
2906899,CARAÍBAS,BA,NORDESTE,6256,1373,4883
2906907,CARAVELAS,BA,NORDESTE,11449,3691,7758
2907004,CARDEAL DA SILVA,BA,NORDESTE,5384,572,4812
2907103,CARINHANHA,BA,NORDESTE,16884,5471,11413
2907202,CASA NOVA,BA,NORDESTE,44439,8878,35561
2907301,CASTRO ALVES,BA,NORDESTE,17100,2997,14103
2907400,CATOLÂNDIA,BA,NORDESTE,3126,649,2477
2907509,CATU,BA,NORDESTE,31327,6684,24643
2907558,CATURAMA,BA,NORDESTE,5401,758,4643
2907608,CENTRAL,BA,NORDESTE,10351,1989,8362
2907707,CHORROCHÓ,BA,NORDESTE,6578,906,5672
2907806,CÍCERO DANTAS,BA,NORDESTE,19601,4436,15165
2907905,CIPÓ,BA,NORDESTE,10056,3067,6989
2908002,COARACI,BA,NORDESTE,11358,3767,7591
2908101,COCOS,BA,NORDESTE,11694,3540,8154
2908200,CONCEIÇÃO DA FEIRA,BA,NORDESTE,13547,2737,10810
2908309,CONCEIÇÃO DO ALMEIDA,BA,NORDESTE,11669,1908,9761
2908408,CONCEIÇÃO DO COITÉ,BA,NORDESTE,42275,15364,26911
2908507,CONCEIÇÃO DO JACUÍPE,BA,NORDESTE,20908,5555,15353
2908606,CONDE,BA,NORDESTE,13551,2798,10753
2908705,CONDEÚBA,BA,NORDESTE,10826,3092,7734
2908804,CONTENDAS DO SINCORÁ,BA,NORDESTE,3222,706,2516
2908903,CORAÇÃO DE MARIA,BA,NORDESTE,16911,2918,13993
2909000,CORDEIROS,BA,NORDESTE,4888,1670,3218
2909109,CORIBE,BA,NORDESTE,9120,2216,6904
2909208,CORONEL JOÃO SÁ,BA,NORDESTE,10842,2005,8837
2909307,CORRENTINA,BA,NORDESTE,19884,4910,14974
2909406,COTEGIPE,BA,NORDESTE,8743,1683,7060
2909505,CRAVOLÂNDIA,BA,NORDESTE,2923,456,2467
2909604,CRISÓPOLIS,BA,NORDESTE,12062,1744,10318
2909703,CRISTÓPOLIS,BA,NORDESTE,9221,2225,6996
2909802,CRUZ DAS ALMAS,BA,NORDESTE,38601,11766,26835
2909901,CURAÇÁ,BA,NORDESTE,20150,3803,16347
2910008,DÁRIO MEIRA,BA,NORDESTE,5667,1177,4490
2910057,DIAS D'ÁVILA,BA,NORDESTE,39698,9999,29699
2910107,DOM BASÍLIO,BA,NORDESTE,8562,1137,7425
2910206,DOM MACEDO COSTA,BA,NORDESTE,3500,974,2526
2910305,ELÍSIO MEDRADO,BA,NORDESTE,5593,1378,4215
2910404,ENCRUZILHADA,BA,NORDESTE,11068,2772,8296
2910503,ENTRE RIOS,BA,NORDESTE,22269,4573,17696
2910602,ESPLANADA,BA,NORDESTE,19579,4059,15520
2910701,EUCLIDES DA CUNHA,BA,NORDESTE,34892,5911,28981
2910727,EUNÁPOLIS,BA,NORDESTE,60849,28290,32559
2910750,FÁTIMA,BA,NORDESTE,11863,1673,10190
2910776,FEIRA DA MATA,BA,NORDESTE,3998,1417,2581
2910800,FEIRA DE SANTANA,BA,NORDESTE,345760,124354,221406
2910859,FILADÉLFIA,BA,NORDESTE,11264,2690,8574
2910909,FIRMINO ALVES,BA,NORDESTE,3557,1112,2445
2911006,FLORESTA AZUL,BA,NORDESTE,5687,1328,4359
2911105,FORMOSA DO RIO PRETO,BA,NORDESTE,14921,4247,10674
2911204,GANDU,BA,NORDESTE,17280,6300,10980
2911253,GAVIÃO,BA,NORDESTE,3216,888,2328
2911303,GENTIO DO OURO,BA,NORDESTE,7568,1072,6496
2911402,GLÓRIA,BA,NORDESTE,9983,1140,8843
2911501,GONGOGI,BA,NORDESTE,3546,794,2752
2911600,GOVERNADOR MANGABEIRA,BA,NORDESTE,13538,2794,10744
2911659,GUAJERU,BA,NORDESTE,4804,596,4208
2911709,GUANAMBI,BA,NORDESTE,52414,18060,34354
2911808,GUARATINGA,BA,NORDESTE,10723,3105,7618
2911857,HELIÓPOLIS,BA,NORDESTE,9084,1153,7931
2911907,IAÇU,BA,NORDESTE,14295,2634,11661
2912004,IBIASSUCÊ,BA,NORDESTE,6597,2111,4486
2912103,IBICARAÍ,BA,NORDESTE,13678,4816,8862
2912202,IBICOARA,BA,NORDESTE,11760,3626,8134
2912301,IBICUÍ,BA,NORDESTE,8682,2420,6262
2912400,IBIPEBA,BA,NORDESTE,10702,1490,9212
2912509,IBIPITANGA,BA,NORDESTE,9156,2175,6981
2912608,IBIQUERA,BA,NORDESTE,2721,405,2316
2912707,IBIRAPITANGA,BA,NORDESTE,9710,2497,7213
2912806,IBIRAPUÃ,BA,NORDESTE,5683,2655,3028
2912905,IBIRATAIA,BA,NORDESTE,10806,3719,7087
2913002,IBITIARA,BA,NORDESTE,8625,1843,6782
2913101,IBITITÁ,BA,NORDESTE,12082,2071,10011
2913200,IBOTIRAMA,BA,NORDESTE,15809,4755,11054
2913309,ICHU,BA,NORDESTE,4721,993,3728
2913408,IGAPORÃ,BA,NORDESTE,9821,1261,8560
2913457,IGRAPIÚNA,BA,NORDESTE,6201,1472,4729
2913507,IGUAÍ,BA,NORDESTE,13219,4155,9064
2913606,ILHÉUS,BA,NORDESTE,99181,38528,60653
2913705,INHAMBUPE,BA,NORDESTE,20328,4181,16147
2913804,IPECAETÁ,BA,NORDESTE,10709,1861,8848
2913903,IPIAÚ,BA,NORDESTE,23599,7799,15800
2914000,IPIRÁ,BA,NORDESTE,34856,6860,27996
2914109,IPUPIARA,BA,NORDESTE,6580,2067,4513
2914208,IRAJUBA,BA,NORDESTE,3944,767,3177
2914307,IRAMAIA,BA,NORDESTE,6300,1308,4992
2914406,IRAQUARA,BA,NORDESTE,14733,1511,13222
2914505,IRARÁ,BA,NORDESTE,18431,3731,14700
2914604,IRECÊ,BA,NORDESTE,39087,11104,27983
2914653,ITABELA,BA,NORDESTE,15805,5956,9849
2914703,ITABERABA,BA,NORDESTE,37213,9681,27532
2914802,ITABUNA,BA,NORDESTE,112100,52768,59332
2914901,ITACARÉ,BA,NORDESTE,13434,3532,9902
2915007,ITAETÉ,BA,NORDESTE,7839,2263,5576
2915106,ITAGI,BA,NORDESTE,7192,2335,4857
2915205,ITAGIBÁ,BA,NORDESTE,8746,2779,5967
2915304,ITAGIMIRIM,BA,NORDESTE,4115,1262,2853
2915353,ITAGUAÇU DA BAHIA,BA,NORDESTE,8047,1221,6826
2915403,ITAJU DO COLÔNIA,BA,NORDESTE,3747,1541,2206
2915502,ITAJUÍPE,BA,NORDESTE,12180,3872,8308
2915601,ITAMARAJU,BA,NORDESTE,33824,16841,16983
2915700,ITAMARI,BA,NORDESTE,4519,1395,3124
2915809,ITAMBÉ,BA,NORDESTE,13775,3951,9824
2915908,ITANAGRA,BA,NORDESTE,4389,768,3621
2916005,ITANHÉM,BA,NORDESTE,10877,3874,7003
2916104,ITAPARICA,BA,NORDESTE,14101,2834,11267
2916203,ITAPÉ,BA,NORDESTE,6185,2112,4073
2916302,ITAPEBI,BA,NORDESTE,5500,1363,4137
2916401,ITAPETINGA,BA,NORDESTE,36631,17204,19427
2916500,ITAPICURU,BA,NORDESTE,17191,2749,14442
2916609,ITAPITANGA,BA,NORDESTE,4462,1165,3297
2916708,ITAQUARA,BA,NORDESTE,4735,1120,3615
2916807,ITARANTIM,BA,NORDESTE,10097,3926,6171
2916856,ITATIM,BA,NORDESTE,9617,2643,6974
2916906,ITIRUÇU,BA,NORDESTE,6814,1740,5074
2917003,ITIÚBA,BA,NORDESTE,20676,5363,15313
2917102,ITORORÓ,BA,NORDESTE,11850,4115,7735
2917201,ITUAÇU,BA,NORDESTE,11938,3456,8482
2917300,ITUBERÁ,BA,NORDESTE,12448,4671,7777
2917334,IUIÚ,BA,NORDESTE,6567,1225,5342
2917359,JABORANDI,BA,NORDESTE,6825,1589,5236
2917409,JACARACI,BA,NORDESTE,8566,1550,7016
2917508,JACOBINA,BA,NORDESTE,45436,12073,33363
2917607,JAGUAQUARA,BA,NORDESTE,25767,7814,17953
2917706,JAGUARARI,BA,NORDESTE,16733,3942,12791
2917805,JAGUARIPE,BA,NORDESTE,11084,2007,9077
2917904,JANDAÍRA,BA,NORDESTE,6105,1039,5066
2918001,JEQUIÉ,BA,NORDESTE,89517,31782,57735
2918100,JEREMOABO,BA,NORDESTE,21847,3652,18195
2918209,JIQUIRIÇÁ,BA,NORDESTE,8196,1713,6483
2918308,JITAÚNA,BA,NORDESTE,8891,2220,6671
2918357,JOÃO DOURADO,BA,NORDESTE,14379,4695,9684
2918407,JUAZEIRO,BA,NORDESTE,126645,41773,84872
2918456,JUCURUÇU,BA,NORDESTE,6099,1773,4326
2918506,JUSSARA,BA,NORDESTE,10242,1012,9230
2918555,JUSSARI,BA,NORDESTE,3294,1183,2111
2918605,JUSSIAPE,BA,NORDESTE,5082,1160,3922
2918704,LAFAIETE COUTINHO,BA,NORDESTE,3170,586,2584
2918753,LAGOA REAL,BA,NORDESTE,8154,1191,6963
2918803,LAJE,BA,NORDESTE,15272,3775,11497
2918902,LAJEDÃO,BA,NORDESTE,3208,1274,1934
2919009,LAJEDINHO,BA,NORDESTE,2626,465,2161
2919058,LAJEDO DO TABOCAL,BA,NORDESTE,4768,873,3895
2919108,LAMARÃO,BA,NORDESTE,5626,629,4997
2919157,LAPÃO,BA,NORDESTE,17719,3562,14157
2919207,LAURO DE FREITAS,BA,NORDESTE,119713,40270,79443
2919306,LENÇÓIS,BA,NORDESTE,6043,896,5147
2919405,LICÍNIO DE ALMEIDA,BA,NORDESTE,7504,1970,5534
2919504,LIVRAMENTO DE NOSSA SENHORA,BA,NORDESTE,27378,6037,21341
2919553,LUÍS EDUARDO MAGALHÃES,BA,NORDESTE,54460,31918,22542
2919603,MACAJUBA,BA,NORDESTE,6779,1511,5268
2919702,MACARANI,BA,NORDESTE,9215,3568,5647
2919801,MACAÚBAS,BA,NORDESTE,24843,5099,19744
2919900,MACURURÉ,BA,NORDESTE,4852,666,4186
2919926,MADRE DE DEUS,BA,NORDESTE,12691,2504,10187
2919959,MAETINGA,BA,NORDESTE,4516,938,3578
2920007,MAIQUINIQUE,BA,NORDESTE,5429,2084,3345
2920106,MAIRI,BA,NORDESTE,10063,2218,7845
2920205,MALHADA,BA,NORDESTE,10101,2758,7343
2920304,MALHADA DE PEDRAS,BA,NORDESTE,6064,1562,4502
2920403,MANOEL VITORINO,BA,NORDESTE,9475,1524,7951
2920452,MANSIDÃO,BA,NORDESTE,6591,1100,5491
2920502,MARACÁS,BA,NORDESTE,15739,3351,12388
2920601,MARAGOGIPE,BA,NORDESTE,26544,5024,21520
2920700,MARAÚ,BA,NORDESTE,10398,2270,8128
2920809,MARCIONÍLIO SOUZA,BA,NORDESTE,5447,1035,4412
2920908,MASCOTE,BA,NORDESTE,6473,1671,4802
2921005,MATA DE SÃO JOÃO,BA,NORDESTE,30695,6890,23805
2921054,MATINA,BA,NORDESTE,7401,790,6611
2921104,MEDEIROS NETO,BA,NORDESTE,13905,5612,8293
2921203,MIGUEL CALMON,BA,NORDESTE,15116,4300,10816
2921302,MILAGRES,BA,NORDESTE,6725,1663,5062
2921401,MIRANGABA,BA,NORDESTE,9106,1858,7248
2921450,MIRANTE,BA,NORDESTE,5831,1048,4783
2921500,MONTE SANTO,BA,NORDESTE,31295,3746,27549
2921609,MORPARÁ,BA,NORDESTE,5695,1499,4196
2921708,MORRO DO CHAPÉU,BA,NORDESTE,19296,4131,15165
2921807,MORTUGABA,BA,NORDESTE,6773,2477,4296
2921906,MUCUGÊ,BA,NORDESTE,7409,2432,4977
2922003,MUCURI,BA,NORDESTE,20267,8897,11370
2922052,MULUNGU DO MORRO,BA,NORDESTE,8204,925,7279
2922102,MUNDO NOVO,BA,NORDESTE,10907,2216,8691
2922201,MUNIZ FERREIRA,BA,NORDESTE,6186,1236,4950
2922250,MUQUÉM DE SÃO FRANCISCO,BA,NORDESTE,7098,1582,5516
2922300,MURITIBA,BA,NORDESTE,17086,2923,14163
2922409,MUTUÍPE,BA,NORDESTE,13258,3484,9774
2922508,NAZARÉ,BA,NORDESTE,16942,3818,13124
2922607,NILO PEÇANHA,BA,NORDESTE,6963,1705,5258
2922656,NORDESTINA,BA,NORDESTE,7537,1257,6280
2922706,NOVA CANAÃ,BA,NORDESTE,9020,1832,7188
2922730,NOVA FÁTIMA,BA,NORDESTE,5755,1383,4372
2922755,NOVA IBIÁ,BA,NORDESTE,3791,1304,2487
2922805,NOVA ITARANA,BA,NORDESTE,4811,1111,3700
2922854,NOVA REDENÇÃO,BA,NORDESTE,4769,545,4224
2922904,NOVA SOURE,BA,NORDESTE,15370,2029,13341
2923001,NOVA VIÇOSA,BA,NORDESTE,22142,10455,11687
2923035,NOVO HORIZONTE,BA,NORDESTE,7207,1506,5701
2923050,NOVO TRIUNFO,BA,NORDESTE,5863,1076,4787
2923100,OLINDINA,BA,NORDESTE,14353,2173,12180
2923209,OLIVEIRA DOS BREJINHOS,BA,NORDESTE,12649,2252,10397
2923308,OURIÇANGAS,BA,NORDESTE,5035,740,4295
2923357,OUROLÂNDIA,BA,NORDESTE,10405,3911,6494
2923407,PALMAS DE MONTE ALTO,BA,NORDESTE,13456,2000,11456
2923506,PALMEIRAS,BA,NORDESTE,6100,839,5261
2923605,PARAMIRIM,BA,NORDESTE,12909,2479,10430
2923704,PARATINGA,BA,NORDESTE,18154,2794,15360
2923803,PARIPIRANGA,BA,NORDESTE,17774,3279,14495
2923902,PAU BRASIL,BA,NORDESTE,5575,2318,3257
2924009,PAULO AFONSO,BA,NORDESTE,62975,13241,49734
2924058,PÉ DE SERRA,BA,NORDESTE,9077,2886,6191
2924108,PEDRÃO,BA,NORDESTE,4869,542,4327
2924207,PEDRO ALEXANDRE,BA,NORDESTE,7297,1045,6252
2924306,PIATÃ,BA,NORDESTE,12020,2850,9170
2924405,PILÃO ARCADO,BA,NORDESTE,20315,3093,17222
2924504,PINDAÍ,BA,NORDESTE,10055,1919,8136
2924603,PINDOBAÇU,BA,NORDESTE,11809,3455,8354
2924652,PINTADAS,BA,NORDESTE,6252,2209,4043
2924678,PIRAÍ DO NORTE,BA,NORDESTE,5037,1258,3779
2924702,PIRIPÁ,BA,NORDESTE,6076,1269,4807
2924801,PIRITIBA,BA,NORDESTE,10455,2529,7926
2924900,PLANALTINO,BA,NORDESTE,5079,889,4190
2925006,PLANALTO,BA,NORDESTE,14742,4166,10576
2925105,POÇÕES,BA,NORDESTE,27215,6553,20662
2925204,POJUCA,BA,NORDESTE,21049,4717,16332
2925253,PONTO NOVO,BA,NORDESTE,10020,2105,7915
2925303,PORTO SEGURO,BA,NORDESTE,78301,33883,44418
2925402,POTIRAGUÁ,BA,NORDESTE,5701,2053,3648
2925501,PRADO,BA,NORDESTE,16975,7407,9568
2925600,PRESIDENTE DUTRA,BA,NORDESTE,9500,1102,8398
2925709,PRESIDENTE JÂNIO QUADROS,BA,NORDESTE,7546,1238,6308
2925758,PRESIDENTE TANCREDO NEVES,BA,NORDESTE,16110,4667,11443
2925808,QUEIMADAS,BA,NORDESTE,15056,3777,11279
2925907,QUIJINGUE,BA,NORDESTE,16002,2725,13277
2925931,QUIXABEIRA,BA,NORDESTE,6487,2473,4014
2925956,RAFAEL JAMBEIRO,BA,NORDESTE,13193,3045,10148
2926004,REMANSO,BA,NORDESTE,24047,4154,19893
2926103,RETIROLÂNDIA,BA,NORDESTE,9550,1936,7614
2926202,RIACHÃO DAS NEVES,BA,NORDESTE,14335,3134,11201
2926301,RIACHÃO DO JACUÍPE,BA,NORDESTE,21933,3816,18117
2926400,RIACHO DE SANTANA,BA,NORDESTE,18112,2542,15570
2926509,RIBEIRA DO AMPARO,BA,NORDESTE,8621,1410,7211
2926608,RIBEIRA DO POMBAL,BA,NORDESTE,32364,7577,24787
2926657,RIBEIRÃO DO LARGO,BA,NORDESTE,5890,1408,4482
2926707,RIO DE CONTAS,BA,NORDESTE,9238,2205,7033
2926806,RIO DO ANTÔNIO,BA,NORDESTE,8209,1494,6715
2926905,RIO DO PIRES,BA,NORDESTE,6277,1242,5035
2927002,RIO REAL,BA,NORDESTE,21181,5782,15399
2927101,RODELAS,BA,NORDESTE,5768,994,4774
2927200,RUY BARBOSA,BA,NORDESTE,17208,3992,13216
2927309,SALINAS DA MARGARIDA,BA,NORDESTE,10582,1734,8848
2927408,SALVADOR,BA,NORDESTE,1541030,451131,1089899
2927507,SANTA BÁRBARA,BA,NORDESTE,15192,2995,12197
2927606,SANTA BRÍGIDA,BA,NORDESTE,8580,1191,7389
2927705,SANTA CRUZ CABRÁLIA,BA,NORDESTE,15692,5914,9778
2927804,SANTA CRUZ DA VITÓRIA,BA,NORDESTE,3123,1227,1896
2927903,SANTA INÊS,BA,NORDESTE,5826,896,4930
2928000,SANTALUZ,BA,NORDESTE,23831,5765,18066
2928059,SANTA LUZIA,BA,NORDESTE,5905,1846,4059
2928109,SANTA MARIA DA VITÓRIA,BA,NORDESTE,23033,6184,16849
2928208,SANTANA,BA,NORDESTE,15918,4121,11797
2928307,SANTANÓPOLIS,BA,NORDESTE,6731,1108,5623
2928406,SANTA RITA DE CÁSSIA,BA,NORDESTE,16463,3417,13046
2928505,SANTA TERESINHA,MT,CENTRO-OESTE,3322,1480,1842
2928604,SANTO AMARO,BA,NORDESTE,36634,5608,31026
2928703,SANTO ANTÔNIO DE JESUS,BA,NORDESTE,58755,18754,40001
2928802,SANTO ESTÊVÃO,BA,NORDESTE,29592,4791,24801
2928901,SÃO DESIDÉRIO,BA,NORDESTE,19797,5990,13807
2928950,SÃO DOMINGOS,BA,NORDESTE,6174,1627,4547
2929008,SÃO FÉLIX,BA,NORDESTE,7964,1315,6649
2929057,SÃO FÉLIX DO CORIBE,BA,NORDESTE,9656,3439,6217
2929107,SÃO FELIPE,BA,NORDESTE,13329,3088,10241
2929206,SÃO FRANCISCO DO CONDE,BA,NORDESTE,25564,3990,21574
2929255,SÃO GABRIEL,BA,NORDESTE,12633,1582,11051
2929305,SÃO GONÇALO DOS CAMPOS,BA,NORDESTE,23312,4301,19011
2929354,SÃO JOSÉ DA VITÓRIA,BA,NORDESTE,3476,1341,2135
2929370,SÃO JOSÉ DO JACUÍPE,BA,NORDESTE,6276,1366,4910
2929404,SÃO MIGUEL DAS MATAS,BA,NORDESTE,7355,1674,5681
2929503,SÃO SEBASTIÃO DO PASSÉ,BA,NORDESTE,26629,3584,23045
2929602,SAPEAÇU,BA,NORDESTE,12110,2881,9229
2929701,SÁTIRO DIAS,BA,NORDESTE,9776,2004,7772
2929750,SAUBARA,BA,NORDESTE,9297,1912,7385
2929800,SAÚDE,BA,NORDESTE,6497,1473,5024
2929909,SEABRA,BA,NORDESTE,27296,4036,23260
2930006,SEBASTIÃO LARANJEIRAS,BA,NORDESTE,5429,1268,4161
2930105,SENHOR DO BONFIM,BA,NORDESTE,39862,13652,26210
2930154,SERRA DO RAMALHO,BA,NORDESTE,18696,4303,14393
2930204,SENTO SÉ,BA,NORDESTE,21752,5448,16304
2930303,SERRA DOURADA,BA,NORDESTE,10950,3819,7131
2930402,SERRA PRETA,BA,NORDESTE,12685,2011,10674
2930501,SERRINHA,BA,NORDESTE,48224,11608,36616
2930600,SERROLÂNDIA,BA,NORDESTE,7729,2123,5606
2930709,SIMÕES FILHO,BA,NORDESTE,67463,18806,48657
2930758,SÍTIO DO MATO,BA,NORDESTE,7997,1894,6103
2930766,SÍTIO DO QUINTO,BA,NORDESTE,7399,1227,6172
2930774,SOBRADINHO,BA,NORDESTE,15179,3519,11660
2930808,SOUTO SOARES,BA,NORDESTE,10954,1067,9887
2930907,TABOCAS DO BREJO VELHO,BA,NORDESTE,7811,1463,6348
2931004,TANHAÇU,BA,NORDESTE,14059,3207,10852
2931053,TANQUE NOVO,BA,NORDESTE,11246,1775,9471
2931103,TANQUINHO,BA,NORDESTE,5851,1224,4627
2931202,TAPEROÁ,BA,NORDESTE,10267,2351,7916
2931301,TAPIRAMUTÁ,BA,NORDESTE,7630,1368,6262
2931350,TEIXEIRA DE FREITAS,BA,NORDESTE,79297,39360,39937
2931400,TEODORO SAMPAIO,BA,NORDESTE,5176,545,4631
2931509,TEOFILÂNDIA,BA,NORDESTE,12998,1793,11205
2931608,TEOLÂNDIA,BA,NORDESTE,8493,1880,6613
2931707,TERRA NOVA,BA,NORDESTE,7683,1285,6398
2931806,TREMEDAL,BA,NORDESTE,10726,2299,8427
2931905,TUCANO,BA,NORDESTE,29927,5879,24048
2932002,UAUÁ,BA,NORDESTE,16442,2264,14178
2932101,UBAÍRA,BA,NORDESTE,11772,3286,8486
2932200,UBAITABA,BA,NORDESTE,9994,3600,6394
2932309,UBATÃ,BA,NORDESTE,8741,2975,5766
2932408,UIBAÍ,BA,NORDESTE,9552,1891,7661
2932457,UMBURANAS,BA,NORDESTE,8258,2347,5911
2932507,UNA,BA,NORDESTE,10918,4355,6563
2932606,URANDI,BA,NORDESTE,9923,1921,8002
2932705,URUÇUCA,BA,NORDESTE,12845,4913,7932
2932804,UTINGA,BA,NORDESTE,9304,1966,7338
2932903,VALENÇA,BA,NORDESTE,47890,15291,32599
2933000,VALENTE,BA,NORDESTE,15228,5088,10140
2933059,VÁRZEA DA ROÇA,BA,NORDESTE,7803,1743,6060
2933109,VÁRZEA DO POÇO,BA,NORDESTE,5101,1301,3800
2933158,VÁRZEA NOVA,BA,NORDESTE,7620,1885,5735
2933174,VARZEDO,BA,NORDESTE,6893,1629,5264
2933208,VERA CRUZ,BA,NORDESTE,25514,5672,19842
2933257,VEREDA,BA,NORDESTE,4798,1486,3312
2933307,VITÓRIA DA CONQUISTA,BA,NORDESTE,201535,84019,117516
2933406,WAGNER,BA,NORDESTE,5061,1068,3993
2933455,WANDERLEY,BA,NORDESTE,8264,2408,5856
2933505,WENCESLAU GUIMARÃES,BA,NORDESTE,11704,3350,8354
2933604,XIQUE-XIQUE,BA,NORDESTE,25930,5629,20301
3100104,ABADIA DOS DOURADOS,MG,SUDESTE,4511,2160,2351
3100203,ABAETÉ,MG,SUDESTE,13998,7696,6302
3100302,ABRE CAMPO,MG,SUDESTE,8957,3665,5292
3100401,ACAIACA,MG,SUDESTE,2570,787,1783
3100500,AÇUCENA,MG,SUDESTE,5415,2069,3346
3100609,ÁGUA BOA,MG,SUDESTE,7589,2796,4793
3100708,ÁGUA COMPRIDA,MG,SUDESTE,1759,1004,755
3100807,AGUANIL,MG,SUDESTE,3046,1439,1607
3100906,ÁGUAS FORMOSAS,MG,SUDESTE,11033,4582,6451
3101003,ÁGUAS VERMELHAS,MG,SUDESTE,6642,1985,4657
3101102,AIMORÉS,MG,SUDESTE,13969,7655,6314
3101201,AIURUOCA,MG,SUDESTE,3891,1797,2094
3101300,ALAGOA,MG,SUDESTE,1929,1259,670
3101409,ALBERTINA,MG,SUDESTE,2326,1611,715
3101508,ALÉM PARAÍBA,MG,SUDESTE,20802,9220,11582
3101607,ALFENAS,MG,SUDESTE,46229,27225,19004
3101631,ALFREDO VASCONCELOS,MG,SUDESTE,4725,1901,2824
3101706,ALMENARA,MG,SUDESTE,21415,5975,15440
3101805,ALPERCATA,MG,SUDESTE,4502,2018,2484
3101904,ALPINÓPOLIS,MG,SUDESTE,12331,6768,5563
3102001,ALTEROSA,MG,SUDESTE,9590,5364,4226
3102050,ALTO CAPARAÓ,MG,SUDESTE,3621,2559,1062
3102100,ALTO RIO DOCE,MG,SUDESTE,7252,1949,5303
3102209,ALVARENGA,MG,SUDESTE,3378,1516,1862
3102308,ALVINÓPOLIS,MG,SUDESTE,9892,3041,6851
3102407,ALVORADA DE MINAS,MG,SUDESTE,3008,724,2284
3102506,AMPARO DO SERRA,MG,SUDESTE,3523,865,2658
3102605,ANDRADAS,MG,SUDESTE,23032,15286,7746
3102704,CACHOEIRA DE PAJEÚ,MG,SUDESTE,4957,1536,3421
3102803,ANDRELÂNDIA,MG,SUDESTE,7137,3159,3978
3102852,ANGELÂNDIA,MG,SUDESTE,4555,2042,2513
3102902,ANTÔNIO CARLOS,MG,SUDESTE,7498,2582,4916
3103009,ANTÔNIO DIAS,MG,SUDESTE,6510,2862,3648
3103108,ANTÔNIO PRADO DE MINAS,MG,SUDESTE,1455,592,863
3103207,ARAÇAÍ,MG,SUDESTE,1884,785,1099
3103306,ARACITABA,MG,SUDESTE,1818,669,1149
3103405,ARAÇUAÍ,MG,SUDESTE,18679,6339,12340
3103504,ARAGUARI,MG,SUDESTE,68220,42103,26117
3103603,ARANTINA,MG,SUDESTE,2132,655,1477
3103702,ARAPONGA,MG,SUDESTE,5159,1317,3842
3103751,ARAPORÃ,MG,SUDESTE,5083,2564,2519
3103801,ARAPUÁ,MG,SUDESTE,2486,1610,876
3103900,ARAÚJOS,MG,SUDESTE,5235,3218,2017
3104007,ARAXÁ,MG,SUDESTE,61076,33959,27117
3104106,ARCEBURGO,MG,SUDESTE,5657,3260,2397
3104205,ARCOS,MG,SUDESTE,25023,14258,10765
3104304,AREADO,MG,SUDESTE,8979,5324,3655
3104403,ARGIRITA,MG,SUDESTE,2249,664,1585
3104452,ARICANDUVA,MG,SUDESTE,3277,969,2308
3104502,ARINOS,MG,SUDESTE,9667,3799,5868
3104601,ASTOLFO DUTRA,MG,SUDESTE,8545,4147,4398
3104700,ATALÉIA,MG,SUDESTE,7469,2334,5135
3104809,AUGUSTO DE LIMA,MG,SUDESTE,2909,1192,1717
3104908,BAEPENDI,MG,SUDESTE,12126,7566,4560
3105004,BALDIM,MG,SUDESTE,5428,2620,2808
3105103,BAMBUÍ,MG,SUDESTE,14176,6622,7554
3105202,BANDEIRA,MG,SUDESTE,3151,573,2578
3105301,BANDEIRA DO SUL,MG,SUDESTE,4074,2328,1746
3105400,BARÃO DE COCAIS,MG,SUDESTE,19029,8147,10882
3105509,BARÃO DE MONTE ALTO,MG,SUDESTE,4186,1466,2720
3105608,BARBACENA,MG,SUDESTE,77253,33503,43750
3105707,BARRA LONGA,MG,SUDESTE,4227,1164,3063
3105905,BARROSO,MG,SUDESTE,13323,5385,7938
3106002,BELA VISTA DE MINAS,MG,SUDESTE,6260,2255,4005
3106101,BELMIRO BRAGA,MG,SUDESTE,2408,795,1613
3106200,BELO HORIZONTE,MG,SUDESTE,1538303,834548,703755
3106309,BELO ORIENTE,MG,SUDESTE,14404,6883,7521
3106408,BELO VALE,MG,SUDESTE,6359,2542,3817
3106507,BERILO,MG,SUDESTE,5611,1303,4308
3106606,BERTÓPOLIS,MG,SUDESTE,3023,822,2201
3106655,BERIZAL,MG,SUDESTE,3022,860,2162
3106705,BETIM,MG,SUDESTE,236178,123818,112360
3106804,BIAS FORTES,MG,SUDESTE,2768,735,2033
3106903,BICAS,MG,SUDESTE,8643,3950,4693
3107000,BIQUINHAS,MG,SUDESTE,1979,954,1025
3107109,BOA ESPERANÇA,MG,SUDESTE,23922,11029,12893
3107208,BOCAINA DE MINAS,MG,SUDESTE,3401,1470,1931
3107307,BOCAIÚVA,MG,SUDESTE,27874,8182,19692
3107406,BOM DESPACHO,MG,SUDESTE,29408,19599,9809
3107505,BOM JARDIM DE MINAS,MG,SUDESTE,4539,1816,2723
3107604,BOM JESUS DA PENHA,MG,SUDESTE,2756,1689,1067
3107703,BOM JESUS DO AMPARO,MG,SUDESTE,3908,1466,2442
3107802,BOM JESUS DO GALHO,MG,SUDESTE,9384,4190,5194
3107901,BOM REPOUSO,MG,SUDESTE,7334,3730,3604
3108008,BOM SUCESSO,MG,SUDESTE,11191,5096,6095
3108107,BONFIM,MG,SUDESTE,5308,2297,3011
3108206,BONFINÓPOLIS DE MINAS,MG,SUDESTE,3555,1460,2095
3108255,BONITO DE MINAS,MG,SUDESTE,5473,950,4523
3108305,BORDA DA MATA,MG,SUDESTE,10085,6026,4059
3108404,BOTELHOS,MG,SUDESTE,9557,4343,5214
3108503,BOTUMIRIM,MG,SUDESTE,3676,806,2870
3108552,BRASILÂNDIA DE MINAS,MG,SUDESTE,8843,3640,5203
3108602,BRASÍLIA DE MINAS,MG,SUDESTE,19033,5601,13432
3108701,BRÁS PIRES,MG,SUDESTE,3266,1240,2026
3108800,BRAÚNAS,MG,SUDESTE,3003,1176,1827
3108909,BRASÓPOLIS,MG,SUDESTE,9292,5131,4161
3109006,BRUMADINHO,MG,SUDESTE,24969,12689,12280
3109105,BUENO BRANDÃO,MG,SUDESTE,6715,4499,2216
3109204,BUENÓPOLIS,MG,SUDESTE,5143,1931,3212
3109253,BUGRE,MG,SUDESTE,3152,1618,1534
3109303,BURITIS,MG,SUDESTE,14004,7637,6367
3109402,BURITIZEIRO,MG,SUDESTE,13843,5906,7937
3109451,CABECEIRA GRANDE,MG,SUDESTE,3979,2029,1950
3109501,CABO VERDE,MG,SUDESTE,7476,3550,3926
3109600,CACHOEIRA DA PRATA,MG,SUDESTE,2773,1334,1439
3109709,CACHOEIRA DE MINAS,MG,SUDESTE,7667,4758,2909
3109808,CACHOEIRA DOURADA,MG,SUDESTE,1824,597,1227
3109907,CAETANÓPOLIS,MG,SUDESTE,6683,3813,2870
3110004,CAETÉ,MG,SUDESTE,25851,11825,14026
3110103,CAIANA,MG,SUDESTE,3257,1411,1846
3110202,CAJURI,MG,SUDESTE,3633,993,2640
3110301,CALDAS,MG,SUDESTE,8336,4893,3443
3110400,CAMACHO,MG,SUDESTE,2508,1057,1451
3110509,CAMANDUCAIA,MG,SUDESTE,13620,7741,5879
3110608,CAMBUÍ,MG,SUDESTE,16298,9500,6798
3110707,CAMBUQUIRA,MG,SUDESTE,7527,3875,3652
3110806,CAMPANÁRIO,MG,SUDESTE,2196,714,1482
3110905,CAMPANHA,MG,SUDESTE,9376,5963,3413
3111002,CAMPESTRE,MG,SUDESTE,12963,8049,4914
3111101,CAMPINA VERDE,MG,SUDESTE,11149,5848,5301
3111150,CAMPO AZUL,MG,SUDESTE,2705,568,2137
3111200,CAMPO BELO,MG,SUDESTE,29676,17341,12335
3111309,CAMPO DO MEIO,MG,SUDESTE,7533,3052,4481
3111408,CAMPO FLORIDO,MG,SUDESTE,4892,2266,2626
3111507,CAMPOS ALTOS,MG,SUDESTE,7222,4319,2903
3111606,CAMPOS GERAIS,MG,SUDESTE,15321,8469,6852
3111705,CANAÃ,MG,SUDESTE,3513,920,2593
3111804,CANÁPOLIS,MG,SUDESTE,6633,2591,4042
3111903,CANA VERDE,MG,SUDESTE,3828,1843,1985
3112000,CANDEIAS,MG,SUDESTE,9120,4819,4301
3112059,CANTAGALO,MG,SUDESTE,2554,695,1859
3112109,CAPARAÓ,MG,SUDESTE,3419,2024,1395
3112208,CAPELA NOVA,MG,SUDESTE,3516,1209,2307
3112307,CAPELINHA,MG,SUDESTE,21315,9118,12197
3112406,CAPETINGA,MG,SUDESTE,4079,2150,1929
3112505,CAPIM BRANCO,MG,SUDESTE,6382,3646,2736
3112604,CAPINÓPOLIS,MG,SUDESTE,8957,3905,5052
3112653,CAPITÃO ANDRADE,MG,SUDESTE,2742,1391,1351
3112703,CAPITÃO ENÉAS,MG,SUDESTE,9140,2607,6533
3112802,CAPITÓLIO,MG,SUDESTE,5995,3676,2319
3112901,CAPUTIRA,MG,SUDESTE,6395,2573,3822
3113008,CARAÍ,MG,SUDESTE,9312,2084,7228
3113107,CARANAÍBA,MG,SUDESTE,2495,1002,1493
3113206,CARANDAÍ,MG,SUDESTE,16351,7374,8977
3113305,CARANGOLA,MG,SUDESTE,18464,8726,9738
3113404,CARATINGA,MG,SUDESTE,47714,25737,21977
3113503,CARBONITA,MG,SUDESTE,5626,1933,3693
3113602,CAREAÇU,MG,SUDESTE,3894,2096,1798
3113701,CARLOS CHAGAS,MG,SUDESTE,10833,4103,6730
3113800,CARMÉSIA,MG,SUDESTE,1766,677,1089
3113909,CARMO DA CACHOEIRA,MG,SUDESTE,7031,2888,4143
3114006,CARMO DA MATA,MG,SUDESTE,7588,3083,4505
3114105,CARMO DE MINAS,MG,SUDESTE,7676,4013,3663
3114204,CARMO DO CAJURU,MG,SUDESTE,14925,8157,6768
3114303,CARMO DO PARANAÍBA,MG,SUDESTE,17025,11066,5959
3114402,CARMO DO RIO CLARO,MG,SUDESTE,12085,7021,5064
3114501,CARMÓPOLIS DE MINAS,MG,SUDESTE,11396,5641,5755
3114550,CARNEIRINHO,MG,SUDESTE,6108,2996,3112
3114600,CARRANCAS,MG,SUDESTE,2702,1231,1471
3114709,CARVALHÓPOLIS,MG,SUDESTE,2619,1480,1139
3114808,CARVALHOS,MG,SUDESTE,3108,1461,1647
3114907,CASA GRANDE,MG,SUDESTE,2107,1110,997
3115003,CASCALHO RICO,MG,SUDESTE,2639,1499,1140
3115102,CÁSSIA,MG,SUDESTE,10386,5441,4945
3115201,CONCEIÇÃO DA BARRA DE MINAS,MG,SUDESTE,2944,1184,1760
3115300,CATAGUASES,MG,SUDESTE,39997,15572,24425
3115359,CATAS ALTAS,MG,SUDESTE,3691,1464,2227
3115409,CATAS ALTAS DA NORUEGA,MG,SUDESTE,2904,930,1974
3115458,CATUJI,MG,SUDESTE,5466,1270,4196
3115474,CATUTI,MG,SUDESTE,3216,847,2369
3115508,CAXAMBU,MG,SUDESTE,12819,6320,6499
3115607,CEDRO DO ABAETÉ,MG,SUDESTE,890,470,420
3115706,CENTRAL DE MINAS,MG,SUDESTE,4181,2095,2086
3115805,CENTRALINA,MG,SUDESTE,5811,2032,3779
3115904,CHÁCARA,MG,SUDESTE,2938,1177,1761
3116001,CHALÉ,MG,SUDESTE,4223,1999,2224
3116100,CHAPADA DO NORTE,MG,SUDESTE,5602,867,4735
3116159,CHAPADA GAÚCHA,MG,SUDESTE,6311,2132,4179
3116209,CHIADOR,MG,SUDESTE,2327,1133,1194
3116308,CIPOTÂNEA,MG,SUDESTE,3905,1277,2628
3116407,CLARAVAL,MG,SUDESTE,3734,2564,1170
3116506,CLARO DOS POÇÕES,MG,SUDESTE,5702,2348,3354
3116605,CLÁUDIO,MG,SUDESTE,17404,11623,5781
3116704,COIMBRA,MG,SUDESTE,5126,1845,3281
3116803,COLUNA,MG,SUDESTE,4590,1554,3036
3116902,COMENDADOR GOMES,MG,SUDESTE,2155,1229,926
3117009,COMERCINHO,MG,SUDESTE,4540,946,3594
3117108,CONCEIÇÃO DA APARECIDA,MG,SUDESTE,6263,3306,2957
3117207,CONCEIÇÃO DAS PEDRAS,MG,SUDESTE,2116,1128,988
3117306,CONCEIÇÃO DAS ALAGOAS,MG,SUDESTE,15106,6737,8369
3117405,CONCEIÇÃO DE IPANEMA,MG,SUDESTE,3258,1340,1918
3117504,CONCEIÇÃO DO MATO DENTRO,MG,SUDESTE,12885,3930,8955
3117603,CONCEIÇÃO DO PARÁ,MG,SUDESTE,3986,2610,1376
3117702,CONCEIÇÃO DO RIO VERDE,MG,SUDESTE,7738,3251,4487
3117801,CONCEIÇÃO DOS OUROS,MG,SUDESTE,7109,4444,2665
3117836,CÔNEGO MARINHO,MG,SUDESTE,4306,671,3635
3117876,CONFINS,MG,SUDESTE,5378,2975,2403
3117900,CONGONHAL,MG,SUDESTE,7540,4696,2844
3118007,CONGONHAS,MG,SUDESTE,33477,15340,18137
3118106,CONGONHAS DO NORTE,MG,SUDESTE,2802,674,2128
3118205,CONQUISTA,MG,SUDESTE,4293,2112,2181
3118304,CONSELHEIRO LAFAIETE,MG,SUDESTE,77460,33282,44178
3118403,CONSELHEIRO PENA,MG,SUDESTE,11553,6507,5046
3118502,CONSOLAÇÃO,MG,SUDESTE,1398,745,653
3118601,CONTAGEM,MG,SUDESTE,365696,202910,162786
3118700,COQUEIRAL,MG,SUDESTE,5847,3147,2700
3118809,CORAÇÃO DE JESUS,MG,SUDESTE,15205,3850,11355
3118908,CORDISBURGO,MG,SUDESTE,5465,2464,3001
3119005,CORDISLÂNDIA,MG,SUDESTE,2115,910,1205
3119104,CORINTO,MG,SUDESTE,13747,5533,8214
3119203,COROACI,MG,SUDESTE,5565,2239,3326
3119302,COROMANDEL,MG,SUDESTE,18135,10710,7425
3119401,CORONEL FABRICIANO,MG,SUDESTE,60871,35727,25144
3119500,CORONEL MURTA,MG,SUDESTE,5233,1226,4007
3119609,CORONEL PACHECO,MG,SUDESTE,2283,956,1327
3119708,CORONEL XAVIER CHAVES,MG,SUDESTE,2344,878,1466
3119807,CÓRREGO DANTA,MG,SUDESTE,2222,1172,1050
3119906,CÓRREGO DO BOM JESUS,MG,SUDESTE,3205,1783,1422
3119955,CÓRREGO FUNDO,MG,SUDESTE,4143,2398,1745
3120003,CÓRREGO NOVO,MG,SUDESTE,2583,891,1692
3120102,COUTO DE MAGALHÃES DE MINAS,MG,SUDESTE,2606,563,2043
3120151,CRISÓLITA,MG,SUDESTE,3269,828,2441
3120201,CRISTAIS,MG,SUDESTE,6500,3266,3234
3120300,CRISTÁLIA,MG,SUDESTE,3440,851,2589
3120409,CRISTIANO OTONI,MG,SUDESTE,3468,1704,1764
3120508,CRISTINA,MG,SUDESTE,6158,3718,2440
3120607,CRUCILÂNDIA,MG,SUDESTE,4062,2167,1895
3120706,CRUZEIRO DA FORTALEZA,MG,SUDESTE,3195,1838,1357
3120805,CRUZÍLIA,MG,SUDESTE,9782,4265,5517
3120839,CUPARAQUE,MG,SUDESTE,2806,1706,1100
3120870,CURRAL DE DENTRO,MG,SUDESTE,4597,1736,2861
3120904,CURVELO,MG,SUDESTE,44720,21381,23339
3121001,DATAS,MG,SUDESTE,3608,834,2774
3121100,DELFIM MOREIRA,MG,SUDESTE,5216,2923,2293
3121209,DELFINÓPOLIS,MG,SUDESTE,4544,2488,2056
3121258,DELTA,MG,SUDESTE,5189,1976,3213
3121308,DESCOBERTO,MG,SUDESTE,3519,1430,2089
3121407,DESTERRO DE ENTRE RIOS,MG,SUDESTE,4755,2807,1948
3121506,DESTERRO DO MELO,MG,SUDESTE,2898,1295,1603
3121605,DIAMANTINA,MG,SUDESTE,27709,8664,19045
3121704,DIOGO DE VASCONCELOS,MG,SUDESTE,2858,680,2178
3121803,DIONÍSIO,MG,SUDESTE,4837,2000,2837
3121902,DIVINÉSIA,MG,SUDESTE,3585,1141,2444
3122009,DIVINO,MG,SUDESTE,11839,5032,6807
3122108,DIVINO DAS LARANJEIRAS,MG,SUDESTE,3177,1625,1552
3122207,DIVINOLÂNDIA DE MINAS,MG,SUDESTE,4082,1602,2480
3122306,DIVINÓPOLIS,MG,SUDESTE,137209,76341,60868
3122355,DIVISA ALEGRE,MG,SUDESTE,3736,1335,2401
3122405,DIVISA NOVA,MG,SUDESTE,3777,1811,1966
3122454,DIVISÓPOLIS,MG,SUDESTE,5024,1619,3405
3122470,DOM BOSCO,MG,SUDESTE,2681,1430,1251
3122504,DOM CAVATI,MG,SUDESTE,3278,1754,1524
3122603,DOM JOAQUIM,MG,SUDESTE,2926,1023,1903
3122702,DOM SILVÉRIO,MG,SUDESTE,3399,1088,2311
3122801,DOM VIÇOSO,MG,SUDESTE,2335,1224,1111
3122900,DONA EUSÉBIA,MG,SUDESTE,4612,2029,2583
3123007,DORES DE CAMPOS,MG,SUDESTE,6469,3229,3240
3123106,DORES DE GUANHÃES,MG,SUDESTE,3602,1310,2292
3123205,DORES DO INDAIÁ,MG,SUDESTE,8073,4783,3290
3123304,DORES DO TURVO,MG,SUDESTE,3901,1392,2509
3123403,DORESÓPOLIS,MG,SUDESTE,1541,808,733
3123502,DOURADOQUARA,MG,SUDESTE,1581,653,928
3123528,DURANDÉ,MG,SUDESTE,4967,2118,2849
3123601,ELÓI MENDES,MG,SUDESTE,15555,9402,6153
3123700,ENGENHEIRO CALDAS,MG,SUDESTE,5298,2570,2728
3123809,ENGENHEIRO NAVARRO,MG,SUDESTE,4422,1200,3222
3123858,ENTRE FOLHAS,MG,SUDESTE,4458,2180,2278
3123908,ENTRE RIOS DE MINAS,MG,SUDESTE,9654,4203,5451
3124005,ERVÁLIA,MG,SUDESTE,12504,4114,8390
3124104,ESMERALDAS,MG,SUDESTE,39832,18715,21117
3124203,ESPERA FELIZ,MG,SUDESTE,13919,6663,7256
3124302,ESPINOSA,MG,SUDESTE,17758,5914,11844
3124401,ESPÍRITO SANTO DO DOURADO,MG,SUDESTE,4023,1989,2034
3124500,ESTIVA,MG,SUDESTE,7417,4150,3267
3124609,ESTRELA DALVA,MG,SUDESTE,1964,716,1248
3124708,ESTRELA DO INDAIÁ,MG,SUDESTE,2076,1045,1031
3124807,ESTRELA DO SUL,MG,SUDESTE,4377,1845,2532
3124906,EUGENÓPOLIS,MG,SUDESTE,7082,3447,3635
3125002,EWBANK DA CÂMARA,MG,SUDESTE,3396,1110,2286
3125101,EXTREMA,MG,SUDESTE,27470,15399,12071
3125200,FAMA,MG,SUDESTE,2359,1272,1087
3125309,FARIA LEMOS,MG,SUDESTE,2404,902,1502
3125408,FELÍCIO DOS SANTOS,MG,SUDESTE,3180,1093,2087
3125507,SÃO GONÇALO DO RIO PRETO,MG,SUDESTE,2079,466,1613
3125606,FELISBURGO,MG,SUDESTE,3727,1026,2701
3125705,FELIXLÂNDIA,MG,SUDESTE,8571,3556,5015
3125804,FERNANDES TOURINHO,MG,SUDESTE,1928,995,933
3125903,FERROS,MG,SUDESTE,6014,1906,4108
3125952,FERVEDOURO,MG,SUDESTE,6559,2703,3856
3126000,FLORESTAL,MG,SUDESTE,5130,2431,2699
3126109,FORMIGA,MG,SUDESTE,41816,26008,15808
3126208,FORMOSO,MG,SUDESTE,4370,1706,2664
3126307,FORTALEZA DE MINAS,MG,SUDESTE,2303,1281,1022
3126406,FORTUNA DE MINAS,MG,SUDESTE,2157,817,1340
3126505,FRANCISCO BADARÓ,MG,SUDESTE,4457,1256,3201
3126604,FRANCISCO DUMONT,MG,SUDESTE,3043,1164,1879
3126703,FRANCISCO SÁ,MG,SUDESTE,14168,3865,10303
3126752,FRANCISCÓPOLIS,MG,SUDESTE,3306,954,2352
3126802,FREI GASPAR,MG,SUDESTE,3764,1177,2587
3126901,FREI INOCÊNCIO,MG,SUDESTE,4878,2032,2846
3126950,FREI LAGONEGRO,MG,SUDESTE,2530,779,1751
3127008,FRONTEIRA,MG,SUDESTE,7843,3594,4249
3127057,FRONTEIRA DOS VALES,MG,SUDESTE,3020,648,2372
3127073,FRUTA DE LEITE,MG,SUDESTE,3096,596,2500
3127107,FRUTAL,MG,SUDESTE,31266,17561,13705
3127206,FUNILÂNDIA,MG,SUDESTE,3682,1995,1687
3127305,GALILÉIA,MG,SUDESTE,3764,1832,1932
3127339,GAMELEIRAS,MG,SUDESTE,3416,1068,2348
3127354,GLAUCILÂNDIA,MG,SUDESTE,3014,847,2167
3127370,GOIABEIRA,MG,SUDESTE,2257,1287,970
3127388,GOIANÁ,MG,SUDESTE,3149,1397,1752
3127404,GONÇALVES,MG,SUDESTE,2968,1853,1115
3127503,GONZAGA,MG,SUDESTE,3028,1143,1885
3127602,GOUVEIA,MG,SUDESTE,7530,2251,5279
3127701,GOVERNADOR VALADARES,MG,SUDESTE,151212,94975,56237
3127800,GRÃO MOGOL,MG,SUDESTE,8166,2109,6057
3127909,GRUPIARA,MG,SUDESTE,1303,774,529
3128006,GUANHÃES,MG,SUDESTE,16881,7434,9447
3128105,GUAPÉ,MG,SUDESTE,8156,5102,3054
3128204,GUARACIABA,MG,SUDESTE,6183,1771,4412
3128253,GUARACIAMA,MG,SUDESTE,3969,657,3312
3128303,GUARANÉSIA,MG,SUDESTE,11558,4779,6779
3128402,GUARANI,MG,SUDESTE,5299,1787,3512
3128501,GUARARÁ,MG,SUDESTE,2693,1181,1512
3128600,GUARDA-MOR,MG,SUDESTE,4289,2270,2019
3128709,GUAXUPÉ,MG,SUDESTE,29300,14500,14800
3128808,GUIDOVAL,MG,SUDESTE,5108,2009,3099
3128907,GUIMARÂNIA,MG,SUDESTE,5252,2856,2396
3129004,GUIRICEMA,MG,SUDESTE,5802,2162,3640
3129103,GURINHATÃ,MG,SUDESTE,3583,1834,1749
3129202,HELIODORA,MG,SUDESTE,4087,1867,2220
3129301,IAPU,MG,SUDESTE,6165,3242,2923
3129400,IBERTIOGA,MG,SUDESTE,3886,1092,2794
3129509,IBIÁ,MG,SUDESTE,12549,6265,6284
3129608,IBIAÍ,MG,SUDESTE,4363,1036,3327
3129657,IBIRACATU,MG,SUDESTE,3742,829,2913
3129707,IBIRACI,MG,SUDESTE,7090,4105,2985
3129806,IBIRITÉ,MG,SUDESTE,98140,49261,48879
3129905,IBITIÚRA DE MINAS,MG,SUDESTE,2632,1885,747
3130002,IBITURUNA,MG,SUDESTE,1958,943,1015
3130051,ICARAÍ DE MINAS,MG,SUDESTE,6150,1744,4406
3130101,IGARAPÉ,MG,SUDESTE,24394,12752,11642
3130200,IGARATINGA,MG,SUDESTE,6414,3651,2763
3130309,IGUATAMA,MG,SUDESTE,4960,2275,2685
3130408,IJACI,MG,SUDESTE,4311,2051,2260
3130507,ILICÍNEA,MG,SUDESTE,7736,3768,3968
3130556,IMBÉ DE MINAS,MG,SUDESTE,4264,1798,2466
3130606,INCONFIDENTES,MG,SUDESTE,5070,2888,2182
3130655,INDAIABIRA,MG,SUDESTE,4277,1846,2431
3130705,INDIANÓPOLIS,MG,SUDESTE,3847,1756,2091
3130804,INGAÍ,MG,SUDESTE,2056,847,1209
3130903,INHAPIM,MG,SUDESTE,14883,8119,6764
3131000,INHAÚMA,MG,SUDESTE,4534,2178,2356
3131109,INIMUTABA,MG,SUDESTE,4612,1837,2775
3131158,IPABA,MG,SUDESTE,9891,5013,4878
3131208,IPANEMA,MG,SUDESTE,11273,5662,5611
3131307,IPATINGA,MG,SUDESTE,136721,89030,47691
3131406,IPIAÇU,MG,SUDESTE,2750,1063,1687
3131505,IPUIÚNA,MG,SUDESTE,6236,3446,2790
3131604,IRAÍ DE MINAS,MG,SUDESTE,4971,2734,2237
3131703,ITABIRA,MG,SUDESTE,71230,32928,38302
3131802,ITABIRINHA,MG,SUDESTE,6092,2938,3154
3131901,ITABIRITO,MG,SUDESTE,32764,14833,17931
3132008,ITACAMBIRA,MG,SUDESTE,3310,666,2644
3132107,ITACARAMBI,MG,SUDESTE,9043,2638,6405
3132206,ITAGUARA,MG,SUDESTE,8390,4541,3849
3132305,ITAIPÉ,MG,SUDESTE,5893,1852,4041
3132404,ITAJUBÁ,MG,SUDESTE,55910,36611,19299
3132503,ITAMARANDIBA,MG,SUDESTE,18625,6969,11656
3132602,ITAMARATI DE MINAS,MG,SUDESTE,2821,1099,1722
3132701,ITAMBACURI,MG,SUDESTE,11892,3862,8030
3132800,ITAMBÉ DO MATO DENTRO,MG,SUDESTE,1930,610,1320
3132909,ITAMOGI,MG,SUDESTE,6921,3725,3196
3133006,ITAMONTE,MG,SUDESTE,9317,5655,3662
3133105,ITANHANDU,MG,SUDESTE,9652,5221,4431
3133204,ITANHOMI,MG,SUDESTE,6698,2940,3758
3133303,ITAOBIM,MG,SUDESTE,11290,4597,6693
3133402,ITAPAGIPE,MG,SUDESTE,7825,4226,3599
3133501,ITAPECERICA,MG,SUDESTE,14105,6519,7586
3133600,ITAPEVA,MG,SUDESTE,6504,4029,2475
3133709,ITATIAIUÇU,MG,SUDESTE,8040,4815,3225
3133758,ITAÚ DE MINAS,MG,SUDESTE,8988,5266,3722
3133808,ITAÚNA,MG,SUDESTE,55667,36985,18682
3133907,ITAVERAVA,MG,SUDESTE,4508,1719,2789
3134004,ITINGA,MG,SUDESTE,7612,1668,5944
3134103,ITUETA,MG,SUDESTE,3907,2483,1424
3134202,ITUIUTABA,MG,SUDESTE,58095,25687,32408
3134301,ITUMIRIM,MG,SUDESTE,4569,2034,2535
3134400,ITURAMA,MG,SUDESTE,22634,10602,12032
3134509,ITUTINGA,MG,SUDESTE,2873,1066,1807
3134608,JABOTICATUBAS,MG,SUDESTE,11666,5490,6176
3134707,JACINTO,MG,SUDESTE,6334,2069,4265
3134806,JACUÍ,MG,SUDESTE,4714,3323,1391
3134905,JACUTINGA,MG,SUDESTE,14475,10464,4011
3135001,JAGUARAÇU,MG,SUDESTE,2455,1281,1174
3135050,JAÍBA,MG,SUDESTE,18851,7421,11430
3135076,JAMPRUCA,MG,SUDESTE,2957,871,2086
3135100,JANAÚBA,MG,SUDESTE,39894,17712,22182
3135209,JANUÁRIA,MG,SUDESTE,34468,8405,26063
3135308,JAPARAÍBA,MG,SUDESTE,2817,1490,1327
3135357,JAPONVAR,MG,SUDESTE,5824,1185,4639
3135407,JECEABA,MG,SUDESTE,4641,1739,2902
3135456,JENIPAPO DE MINAS,MG,SUDESTE,3636,892,2744
3135506,JEQUERI,MG,SUDESTE,7426,2284,5142
3135605,JEQUITAÍ,MG,SUDESTE,4340,1281,3059
3135704,JEQUITIBÁ,MG,SUDESTE,4464,2262,2202
3135803,JEQUITINHONHA,MG,SUDESTE,12061,2842,9219
3135902,JESUÂNIA,MG,SUDESTE,3223,1786,1437
3136009,JOAÍMA,MG,SUDESTE,7092,1680,5412
3136108,JOANÉSIA,MG,SUDESTE,3486,1507,1979
3136207,JOÃO MONLEVADE,MG,SUDESTE,46293,23348,22945
3136306,JOÃO PINHEIRO,MG,SUDESTE,27523,14606,12917
3136405,JOAQUIM FELÍCIO,MG,SUDESTE,2375,1017,1358
3136504,JORDÂNIA,MG,SUDESTE,5197,1825,3372
3136520,JOSÉ GONÇALVES DE MINAS,MG,SUDESTE,2433,668,1765
3136553,JOSÉ RAYDAN,MG,SUDESTE,2727,960,1767
3136579,JOSENÓPOLIS,MG,SUDESTE,2148,530,1618
3136603,NOVA UNIÃO,MG,SUDESTE,4178,1741,2437
3136652,JUATUBA,MG,SUDESTE,17455,8879,8576
3136702,JUIZ DE FORA,MG,SUDESTE,322605,141651,180954
3136801,JURAMENTO,MG,SUDESTE,3505,1071,2434
3136900,JURUAIA,MG,SUDESTE,7341,4525,2816
3136959,JUVENÍLIA,MG,SUDESTE,3719,1193,2526
3137007,LADAINHA,MG,SUDESTE,7573,1912,5661
3137106,LAGAMAR,MG,SUDESTE,5006,2814,2192
3137205,LAGOA DA PRATA,MG,SUDESTE,27950,17251,10699
3137304,LAGOA DOS PATOS,MG,SUDESTE,2562,936,1626
3137403,LAGOA DOURADA,MG,SUDESTE,8176,4084,4092
3137502,LAGOA FORMOSA,MG,SUDESTE,11844,6545,5299
3137536,LAGOA GRANDE,MG,SUDESTE,5733,2519,3214
3137601,LAGOA SANTA,MG,SUDESTE,38741,23835,14906
3137700,LAJINHA,MG,SUDESTE,12217,6327,5890
3137809,LAMBARI,MG,SUDESTE,13032,8276,4756
3137908,LAMIM,MG,SUDESTE,2793,734,2059
3138005,LARANJAL,MG,SUDESTE,4443,2213,2230
3138104,LASSANCE,MG,SUDESTE,4111,1427,2684
3138203,LAVRAS,MG,SUDESTE,56860,29296,27564
3138302,LEANDRO FERREIRA,MG,SUDESTE,2563,1459,1104
3138351,LEME DO PRADO,MG,SUDESTE,2848,765,2083
3138401,LEOPOLDINA,MG,SUDESTE,30686,12305,18381
3138500,LIBERDADE,MG,SUDESTE,3331,1178,2153
3138609,LIMA DUARTE,MG,SUDESTE,11035,3270,7765
3138625,LIMEIRA DO OESTE,MG,SUDESTE,4944,2167,2777
3138658,LONTRA,MG,SUDESTE,5799,1533,4266
3138674,LUISBURGO,MG,SUDESTE,4535,2719,1816
3138682,LUISLÂNDIA,MG,SUDESTE,4499,775,3724
3138708,LUMINÁRIAS,MG,SUDESTE,3503,1562,1941
3138807,LUZ,MG,SUDESTE,10683,6206,4477
3138906,MACHACALIS,MG,SUDESTE,4372,1544,2828
3139003,MACHADO,MG,SUDESTE,23154,14248,8906
3139102,MADRE DE DEUS DE MINAS,MG,SUDESTE,3469,1349,2120
3139201,MALACACHETA,MG,SUDESTE,10079,3424,6655
3139250,MAMONAS,MG,SUDESTE,4561,1400,3161
3139300,MANGA,MG,SUDESTE,11054,3790,7264
3139409,MANHUAÇU,MG,SUDESTE,46569,26099,20470
3139508,MANHUMIRIM,MG,SUDESTE,12612,6301,6311
3139607,MANTENA,MG,SUDESTE,14770,8689,6081
3139706,MARAVILHAS,MG,SUDESTE,5133,2881,2252
3139805,MAR DE ESPANHA,MG,SUDESTE,8097,3766,4331
3139904,MARIA DA FÉ,MG,SUDESTE,9627,6067,3560
3140001,MARIANA,MG,SUDESTE,38796,11885,26911
3140100,MARILAC,MG,SUDESTE,2989,1012,1977
3140159,MÁRIO CAMPOS,MG,SUDESTE,9683,5079,4604
3140209,MARIPÁ DE MINAS,MG,SUDESTE,2367,1207,1160
3140308,MARLIÉRIA,MG,SUDESTE,3345,1581,1764
3140407,MARMELÓPOLIS,MG,SUDESTE,2286,1139,1147
3140506,MARTINHO CAMPOS,MG,SUDESTE,8541,5263,3278
3140530,MARTINS SOARES,MG,SUDESTE,6030,2820,3210
3140555,MATA VERDE,MG,SUDESTE,4922,1917,3005
3140605,MATERLÂNDIA,MG,SUDESTE,2651,598,2053
3140704,MATEUS LEME,MG,SUDESTE,20334,10764,9570
3140803,MATIAS BARBOSA,MG,SUDESTE,9463,4098,5365
3140852,MATIAS CARDOSO,MG,SUDESTE,4932,1376,3556
3140902,MATIPÓ,MG,SUDESTE,11358,5149,6209
3141009,MATO VERDE,MG,SUDESTE,8339,3077,5262
3141108,MATOZINHOS,MG,SUDESTE,23049,11720,11329
3141207,MATUTINA,MG,SUDESTE,2502,1340,1162
3141306,MEDEIROS,MG,SUDESTE,2405,1457,948
3141405,MEDINA,MG,SUDESTE,11240,3543,7697
3141504,MENDES PIMENTEL,MG,SUDESTE,3755,1648,2107
3141603,MERCÊS,MG,SUDESTE,6631,2150,4481
3141702,MESQUITA,MG,SUDESTE,3808,1790,2018
3141801,MINAS NOVAS,MG,SUDESTE,13551,2871,10680
3141900,MINDURI,MG,SUDESTE,2539,1249,1290
3142007,MIRABELA,MG,SUDESTE,8354,2321,6033
3142106,MIRADOURO,MG,SUDESTE,6397,2599,3798
3142205,MIRAÍ,MG,SUDESTE,7887,4068,3819
3142254,MIRAVÂNIA,MG,SUDESTE,2563,611,1952
3142304,MOEDA,MG,SUDESTE,4106,2051,2055
3142403,MOEMA,MG,SUDESTE,5080,2761,2319
3142502,MONJOLOS,MG,SUDESTE,1577,539,1038
3142601,MONSENHOR PAULO,MG,SUDESTE,5416,2749,2667
3142700,MONTALVÂNIA,MG,SUDESTE,8686,2618,6068
3142809,MONTE ALEGRE DE MINAS,MG,SUDESTE,11192,5351,5841
3142908,MONTE AZUL,MG,SUDESTE,13533,5340,8193
3143005,MONTE BELO,MG,SUDESTE,8285,4174,4111
3143104,MONTE CARMELO,MG,SUDESTE,27906,13471,14435
3143153,MONTE FORMOSO,MG,SUDESTE,2750,614,2136
3143203,MONTE SANTO DE MINAS,MG,SUDESTE,12353,6694,5659
3143302,MONTES CLAROS,MG,SUDESTE,227835,116755,111080
3143401,MONTE SIÃO,MG,SUDESTE,14595,11161,3434
3143450,MONTEZUMA,MG,SUDESTE,4079,1249,2830
3143500,MORADA NOVA DE MINAS,MG,SUDESTE,5396,2970,2426
3143609,MORRO DA GARÇA,MG,SUDESTE,2089,624,1465
3143708,MORRO DO PILAR,MG,SUDESTE,2666,773,1893
3143807,MUNHOZ,MG,SUDESTE,4631,2507,2124
3143906,MURIAÉ,MG,SUDESTE,60871,32191,28680
3144003,MUTUM,MG,SUDESTE,16463,8561,7902
3144102,MUZAMBINHO,MG,SUDESTE,13710,7574,6136
3144201,NACIP RAYDAN,MG,SUDESTE,1803,590,1213
3144300,NANUQUE,MG,SUDESTE,20259,10130,10129
3144359,NAQUE,MG,SUDESTE,3915,1667,2248
3144375,NATALÂNDIA,MG,SUDESTE,2366,914,1452
3144409,NATÉRCIA,MG,SUDESTE,3142,1956,1186
3144508,NAZARENO,MG,SUDESTE,5129,1769,3360
3144607,NEPOMUCENO,MG,SUDESTE,15743,8190,7553
3144656,NINHEIRA,MG,SUDESTE,5401,1663,3738
3144672,NOVA BELÉM,MG,SUDESTE,2586,1147,1439
3144706,NOVA ERA,MG,SUDESTE,11055,4532,6523
3144805,NOVA LIMA,MG,SUDESTE,59635,29146,30489
3144904,NOVA MÓDICA,MG,SUDESTE,2484,952,1532
3145000,NOVA PONTE,MG,SUDESTE,9434,4871,4563
3145059,NOVA PORTEIRINHA,MG,SUDESTE,4691,1668,3023
3145109,NOVA RESENDE,MG,SUDESTE,10215,6068,4147
3145208,NOVA SERRANA,MG,SUDESTE,48147,34819,13328
3145307,NOVO CRUZEIRO,MG,SUDESTE,14624,3407,11217
3145356,NOVO ORIENTE DE MINAS,MG,SUDESTE,5671,1503,4168
3145372,NOVORIZONTE,MG,SUDESTE,3392,1264,2128
3145406,OLARIA,MG,SUDESTE,1733,553,1180
3145455,OLHOS-D'ÁGUA,MG,SUDESTE,3843,904,2939
3145505,OLÍMPIO NORONHA,MG,SUDESTE,2012,819,1193
3145604,OLIVEIRA,MG,SUDESTE,25773,12969,12804
3145703,OLIVEIRA FORTES,MG,SUDESTE,1956,547,1409
3145802,ONÇA DE PITANGUI,MG,SUDESTE,2597,1583,1014
3145851,ORATÓRIOS,MG,SUDESTE,3308,785,2523
3145877,ORIZÂNIA,MG,SUDESTE,4941,2219,2722
3145901,OURO BRANCO,MG,SUDESTE,24826,12941,11885
3146008,OURO FINO,MG,SUDESTE,18957,12819,6138
3146107,OURO PRETO,MG,SUDESTE,49459,14872,34587
3146206,OURO VERDE DE MINAS,MG,SUDESTE,4806,1896,2910
3146255,PADRE CARVALHO,MG,SUDESTE,3107,902,2205
3146305,PADRE PARAÍSO,MG,SUDESTE,9014,3419,5595
3146404,PAINEIRAS,MG,SUDESTE,3197,1289,1908
3146503,PAINS,MG,SUDESTE,5364,2854,2510
3146552,PAI PEDRO,MG,SUDESTE,3815,934,2881
3146602,PAIVA,MG,SUDESTE,1315,443,872
3146701,PALMA,MG,SUDESTE,4057,1466,2591
3146750,PALMÓPOLIS,MG,SUDESTE,4015,1007,3008
3146909,PAPAGAIOS,MG,SUDESTE,9353,4748,4605
3147006,PARACATU,MG,SUDESTE,49724,28345,21379
3147105,PARÁ DE MINAS,MG,SUDESTE,51462,33252,18210
3147204,PARAGUAÇU,MG,SUDESTE,12985,7022,5963
3147303,PARAISÓPOLIS,MG,SUDESTE,12521,7517,5004
3147402,PARAOPEBA,MG,SUDESTE,15747,8438,7309
3147501,PASSABÉM,MG,SUDESTE,1389,518,871
3147600,PASSA QUATRO,MG,SUDESTE,10338,4946,5392
3147709,PASSA TEMPO,MG,SUDESTE,5583,2372,3211
3147808,PASSA-VINTE,MG,SUDESTE,1848,848,1000
3147907,PASSOS,MG,SUDESTE,60693,32256,28437
3147956,PATIS,MG,SUDESTE,3694,736,2958
3148004,PATOS DE MINAS,MG,SUDESTE,86905,56293,30612
3148103,PATROCÍNIO,MG,SUDESTE,52304,31972,20332
3148202,PATROCÍNIO DO MURIAÉ,MG,SUDESTE,3991,1707,2284
3148301,PAULA CÂNDIDO,MG,SUDESTE,5838,1659,4179
3148400,PAULISTAS,MG,SUDESTE,2896,556,2340
3148509,PAVÃO,MG,SUDESTE,4359,1403,2956
3148608,PEÇANHA,MG,SUDESTE,8818,3033,5785
3148707,PEDRA AZUL,MG,SUDESTE,11730,4712,7018
3148756,PEDRA BONITA,MG,SUDESTE,4751,2496,2255
3148806,PEDRA DO ANTA,MG,SUDESTE,2699,729,1970
3148905,PEDRA DO INDAIÁ,MG,SUDESTE,2899,1726,1173
3149002,PEDRA DOURADA,MG,SUDESTE,2151,824,1327
3149101,PEDRALVA,MG,SUDESTE,7292,4307,2985
3149150,PEDRAS DE MARIA DA CRUZ,MG,SUDESTE,5274,1199,4075
3149200,PEDRINÓPOLIS,MG,SUDESTE,2479,1283,1196
3149309,PEDRO LEOPOLDO,MG,SUDESTE,38156,21063,17093
3149408,PEDRO TEIXEIRA,MG,SUDESTE,1930,435,1495
3149507,PEQUERI,MG,SUDESTE,2439,1043,1396
3149606,PEQUI,MG,SUDESTE,2928,1495,1433
3149705,PERDIGÃO,MG,SUDESTE,6478,4892,1586
3149804,PERDIZES,MG,SUDESTE,10010,5847,4163
3149903,PERDÕES,MG,SUDESTE,13338,7363,5975
3149952,PERIQUITO,MG,SUDESTE,4629,2182,2447
3150000,PESCADOR,MG,SUDESTE,2306,774,1532
3150109,PIAU,MG,SUDESTE,2440,841,1599
3150158,PIEDADE DE CARATINGA,MG,SUDESTE,5871,3236,2635
3150208,PIEDADE DE PONTE NOVA,MG,SUDESTE,2886,838,2048
3150307,PIEDADE DO RIO GRANDE,MG,SUDESTE,3006,1201,1805
3150406,PIEDADE DOS GERAIS,MG,SUDESTE,3804,1943,1861
3150505,PIMENTA,MG,SUDESTE,5419,3011,2408
3150539,PINGO-D'ÁGUA,MG,SUDESTE,3158,1171,1987
3150570,PINTÓPOLIS,MG,SUDESTE,4287,1142,3145
3150604,PIRACEMA,MG,SUDESTE,4704,1929,2775
3150703,PIRAJUBA,MG,SUDESTE,3375,1586,1789
3150802,PIRANGA,MG,SUDESTE,9290,3170,6120
3150901,PIRANGUÇU,MG,SUDESTE,3650,2263,1387
3151008,PIRANGUINHO,MG,SUDESTE,5635,3032,2603
3151107,PIRAPETINGA,MG,SUDESTE,7805,3459,4346
3151206,PIRAPORA,MG,SUDESTE,30169,16654,13515
3151305,PIRAÚBA,MG,SUDESTE,7556,3200,4356
3151404,PITANGUI,MG,SUDESTE,16915,10955,5960
3151503,PIUMHI,MG,SUDESTE,19518,12460,7058
3151602,PLANURA,MG,SUDESTE,6138,3045,3093
3151701,POÇO FUNDO,MG,SUDESTE,10273,5208,5065
3151800,POÇOS DE CALDAS,MG,SUDESTE,89304,52121,37183
3151909,POCRANE,MG,SUDESTE,5563,2631,2932
3152006,POMPÉU,MG,SUDESTE,18343,8089,10254
3152105,PONTE NOVA,MG,SUDESTE,34370,11451,22919
3152131,PONTO CHIQUE,MG,SUDESTE,2532,531,2001
3152170,PONTO DOS VOLANTES,MG,SUDESTE,6184,1829,4355
3152204,PORTEIRINHA,MG,SUDESTE,23445,8462,14983
3152303,PORTO FIRME,MG,SUDESTE,6900,2290,4610
3152402,POTÉ,MG,SUDESTE,8219,3356,4863
3152501,POUSO ALEGRE,MG,SUDESTE,84390,50221,34169
3152600,POUSO ALTO,MG,SUDESTE,4351,2431,1920
3152709,PRADOS,MG,SUDESTE,5902,2173,3729
3152808,PRATA,MG,SUDESTE,16302,7615,8687
3152907,PRATÁPOLIS,MG,SUDESTE,5541,2898,2643
3153004,PRATINHA,MG,SUDESTE,2276,1423,853
3153103,PRESIDENTE BERNARDES,MG,SUDESTE,4062,1212,2850
3153202,PRESIDENTE JUSCELINO,MG,SUDESTE,2655,865,1790
3153301,PRESIDENTE KUBITSCHEK,MG,SUDESTE,2205,341,1864
3153400,PRESIDENTE OLEGÁRIO,MG,SUDESTE,11806,6159,5647
3153509,ALTO JEQUITIBÁ,MG,SUDESTE,5563,3581,1982
3153608,PRUDENTE DE MORAIS,MG,SUDESTE,6497,3372,3125
3153707,QUARTEL GERAL,MG,SUDESTE,2548,1049,1499
3153806,QUELUZITO,MG,SUDESTE,2019,896,1123
3153905,RAPOSOS,MG,SUDESTE,10731,4020,6711
3154002,RAUL SOARES,MG,SUDESTE,13407,5412,7995
3154101,RECREIO,MG,SUDESTE,5938,2284,3654
3154150,REDUTO,MG,SUDESTE,4495,2189,2306
3154200,RESENDE COSTA,MG,SUDESTE,7347,3386,3961
3154309,RESPLENDOR,MG,SUDESTE,9006,5747,3259
3154408,RESSAQUINHA,MG,SUDESTE,3470,1274,2196
3154457,RIACHINHO,MG,SUDESTE,4169,1506,2663
3154507,RIACHO DOS MACHADOS,MG,SUDESTE,5394,1516,3878
3154606,RIBEIRÃO DAS NEVES,MG,SUDESTE,171207,84526,86681
3154705,RIBEIRÃO VERMELHO,MG,SUDESTE,2622,1063,1559
3154804,RIO ACIMA,MG,SUDESTE,6847,3093,3754
3154903,RIO CASCA,MG,SUDESTE,7770,2625,5145
3155009,RIO DOCE,MG,SUDESTE,1959,645,1314
3155108,RIO DO PRADO,MG,SUDESTE,2935,594,2341
3155207,RIO ESPERA,MG,SUDESTE,4019,1495,2524
3155306,RIO MANSO,MG,SUDESTE,3709,1617,2092
3155405,RIO NOVO,MG,SUDESTE,5543,2265,3278
3155504,RIO PARANAÍBA,MG,SUDESTE,8022,3937,4085
3155603,RIO PARDO DE MINAS,MG,SUDESTE,15067,5913,9154
3155702,RIO PIRACICABA,MG,SUDESTE,9108,3587,5521
3155801,RIO POMBA,MG,SUDESTE,11036,4599,6437
3155900,RIO PRETO,MG,SUDESTE,4087,1441,2646
3156007,RIO VERMELHO,MG,SUDESTE,6273,1861,4412
3156106,RITÁPOLIS,MG,SUDESTE,3594,1297,2297
3156205,ROCHEDO DE MINAS,MG,SUDESTE,1893,939,954
3156304,RODEIRO,MG,SUDESTE,5331,2501,2830
3156403,ROMARIA,MG,SUDESTE,2573,939,1634
3156452,ROSÁRIO DA LIMEIRA,MG,SUDESTE,4007,1480,2527
3156502,RUBELITA,MG,SUDESTE,4732,837,3895
3156601,RUBIM,MG,SUDESTE,4720,1289,3431
3156700,SABARÁ,MG,SUDESTE,75347,37228,38119
3156809,SABINÓPOLIS,MG,SUDESTE,8059,2205,5854
3156908,SACRAMENTO,MG,SUDESTE,15125,8867,6258
3157005,SALINAS,MG,SUDESTE,23768,9031,14737
3157104,SALTO DA DIVISA,MG,SUDESTE,3451,1100,2351
3157203,SANTA BÁRBARA,MG,SUDESTE,18552,6894,11658
3157252,SANTA BÁRBARA DO LESTE,MG,SUDESTE,5618,2892,2726
3157278,SANTA BÁRBARA DO MONTE VERDE,MG,SUDESTE,2617,944,1673
3157302,SANTA BÁRBARA DO TUGÚRIO,MG,SUDESTE,3457,878,2579
3157336,SANTA CRUZ DE MINAS,MG,SUDESTE,5140,2865,2275
3157377,SANTA CRUZ DE SALINAS,MG,SUDESTE,2895,460,2435
3157401,SANTA CRUZ DO ESCALVADO,MG,SUDESTE,3691,1024,2667
3157500,SANTA EFIGÊNIA DE MINAS,MG,SUDESTE,2578,841,1737
3157609,SANTA FÉ DE MINAS,MG,SUDESTE,2288,554,1734
3157658,SANTA HELENA DE MINAS,MG,SUDESTE,3826,967,2859
3157708,SANTA JULIANA,MG,SUDESTE,8405,4449,3956
3157807,SANTA LUZIA,MG,SUDESTE,132231,68438,63793
3157906,SANTA MARGARIDA,MG,SUDESTE,10439,5231,5208
3158003,SANTA MARIA DE ITABIRA,MG,SUDESTE,6595,2158,4437
3158102,SANTA MARIA DO SALTO,MG,SUDESTE,2921,1096,1825
3158201,SANTA MARIA DO SUAÇUÍ,MG,SUDESTE,7694,2640,5054
3158300,SANTANA DA VARGEM,MG,SUDESTE,4860,2341,2519
3158409,SANTANA DE CATAGUASES,MG,SUDESTE,2693,1279,1414
3158508,SANTANA DE PIRAPAMA,MG,SUDESTE,5643,2344,3299
3158607,SANTANA DO DESERTO,MG,SUDESTE,2699,934,1765
3158706,SANTANA DO GARAMBÉU,MG,SUDESTE,1796,507,1289
3158805,SANTANA DO JACARÉ,MG,SUDESTE,3095,1441,1654
3158904,SANTANA DO MANHUAÇU,MG,SUDESTE,5752,2383,3369
3158953,SANTANA DO PARAÍSO,MG,SUDESTE,17656,10563,7093
3159001,SANTANA DO RIACHO,MG,SUDESTE,4243,1588,2655
3159100,SANTANA DOS MONTES,MG,SUDESTE,2894,1090,1804
3159209,SANTA RITA DE CALDAS,MG,SUDESTE,5543,3488,2055
3159308,SANTA RITA DE JACUTINGA,MG,SUDESTE,3377,1248,2129
3159357,SANTA RITA DE MINAS,MG,SUDESTE,4595,2365,2230
3159407,SANTA RITA DE IBITIPOCA,MG,SUDESTE,2471,649,1822
3159506,SANTA RITA DO ITUETO,MG,SUDESTE,3715,2178,1537
3159605,SANTA RITA DO SAPUCAÍ,MG,SUDESTE,24229,16127,8102
3159704,SANTA ROSA DA SERRA,MG,SUDESTE,2378,1138,1240
3159803,SANTA VITÓRIA,MG,SUDESTE,12997,5437,7560
3159902,SANTO ANTÔNIO DO AMPARO,MG,SUDESTE,10851,3635,7216
3160009,SANTO ANTÔNIO DO AVENTUREIRO,MG,SUDESTE,2859,1239,1620
3160108,SANTO ANTÔNIO DO GRAMA,MG,SUDESTE,2968,856,2112
3160207,SANTO ANTÔNIO DO ITAMBÉ,MG,SUDESTE,2245,481,1764
3160306,SANTO ANTÔNIO DO JACINTO,MG,SUDESTE,6182,2338,3844
3160405,SANTO ANTÔNIO DO MONTE,MG,SUDESTE,15937,11569,4368
3160454,SANTO ANTÔNIO DO RETIRO,MG,SUDESTE,4342,1233,3109
3160504,SANTO ANTÔNIO DO RIO ABAIXO,MG,SUDESTE,1528,566,962
3160603,SANTO HIPÓLITO,MG,SUDESTE,2004,558,1446
3160702,SANTOS DUMONT,MG,SUDESTE,29191,11152,18039
3160801,SÃO BENTO ABADE,MG,SUDESTE,3215,1571,1644
3160900,SÃO BRÁS DO SUAÇUÍ,MG,SUDESTE,2690,986,1704
3160959,SÃO DOMINGOS DAS DORES,MG,SUDESTE,4146,2238,1908
3161007,SÃO DOMINGOS DO PRATA,MG,SUDESTE,10787,4125,6662
3161056,SÃO FÉLIX DE MINAS,MG,SUDESTE,2387,1121,1266
3161106,SÃO FRANCISCO,MG,SUDESTE,28190,8931,19259
3161205,SÃO FRANCISCO DE PAULA,MG,SUDESTE,4704,1769,2935
3161304,SÃO FRANCISCO DE SALES,MG,SUDESTE,3629,1423,2206
3161403,SÃO FRANCISCO DO GLÓRIA,MG,SUDESTE,3311,1181,2130
3161502,SÃO GERALDO,MG,SUDESTE,5579,1929,3650
3161601,SÃO GERALDO DA PIEDADE,MG,SUDESTE,2470,860,1610
3161650,SÃO GERALDO DO BAIXIO,MG,SUDESTE,2236,1009,1227
3161700,SÃO GONÇALO DO ABAETÉ,MG,SUDESTE,3978,1966,2012
3161809,SÃO GONÇALO DO PARÁ,MG,SUDESTE,6876,3814,3062
3161908,SÃO GONÇALO DO RIO ABAIXO,MG,SUDESTE,8761,3534,5227
3162005,SÃO GONÇALO DO SAPUCAÍ,MG,SUDESTE,13917,7459,6458
3162104,SÃO GOTARDO,MG,SUDESTE,21009,13122,7887
3162203,SÃO JOÃO BATISTA DO GLÓRIA,MG,SUDESTE,4944,2909,2035
3162252,SÃO JOÃO DA LAGOA,MG,SUDESTE,3656,958,2698
3162302,SÃO JOÃO DA MATA,MG,SUDESTE,2329,1424,905
3162401,SÃO JOÃO DA PONTE,MG,SUDESTE,14843,2813,12030
3162450,SÃO JOÃO DAS MISSÕES,MG,SUDESTE,6917,1678,5239
3162500,SÃO JOÃO DEL REI,MG,SUDESTE,55030,28797,26233
3162559,SÃO JOÃO DO MANHUAÇU,MG,SUDESTE,7445,3925,3520
3162575,SÃO JOÃO DO MANTENINHA,MG,SUDESTE,3755,1860,1895
3162609,SÃO JOÃO DO ORIENTE,MG,SUDESTE,5274,2414,2860
3162658,SÃO JOÃO DO PACUÍ,MG,SUDESTE,2848,641,2207
3162708,SÃO JOÃO DO PARAÍSO,MG,SUDESTE,11991,5568,6423
3162807,SÃO JOÃO EVANGELISTA,MG,SUDESTE,8894,2497,6397
3162906,SÃO JOÃO NEPOMUCENO,MG,SUDESTE,15547,7479,8068
3162922,SÃO JOAQUIM DE BICAS,MG,SUDESTE,16182,7479,8703
3162948,SÃO JOSÉ DA BARRA,MG,SUDESTE,5034,2606,2428
3162955,SÃO JOSÉ DA LAPA,MG,SUDESTE,15666,8535,7131
3163003,SÃO JOSÉ DA SAFIRA,MG,SUDESTE,2652,1042,1610
3163102,SÃO JOSÉ DA VARGINHA,MG,SUDESTE,2940,1509,1431
3163201,SÃO JOSÉ DO ALEGRE,MG,SUDESTE,2857,1756,1101
3163300,SÃO JOSÉ DO DIVINO,MG,SUDESTE,2345,1181,1164
3163409,SÃO JOSÉ DO GOIABAL,MG,SUDESTE,3377,1089,2288
3163508,SÃO JOSÉ DO JACURI,MG,SUDESTE,3802,1103,2699
3163607,SÃO JOSÉ DO MANTIMENTO,MG,SUDESTE,2248,919,1329
3163706,SÃO LOURENÇO,MG,SUDESTE,26032,16504,9528
3163805,SÃO MIGUEL DO ANTA,MG,SUDESTE,4876,1533,3343
3163904,SÃO PEDRO DA UNIÃO,MG,SUDESTE,3264,1830,1434
3164001,SÃO PEDRO DOS FERROS,MG,SUDESTE,4492,1249,3243
3164100,SÃO PEDRO DO SUAÇUÍ,MG,SUDESTE,3399,1168,2231
3164209,SÃO ROMÃO,MG,SUDESTE,4560,1389,3171
3164308,SÃO ROQUE DE MINAS,MG,SUDESTE,4370,3251,1119
3164407,SÃO SEBASTIÃO DA BELA VISTA,MG,SUDESTE,4452,2366,2086
3164431,SÃO SEBASTIÃO DA VARGEM ALEGRE,MG,SUDESTE,2266,964,1302
3164472,SÃO SEBASTIÃO DO ANTA,MG,SUDESTE,3862,1993,1869
3164506,SÃO SEBASTIÃO DO MARANHÃO,MG,SUDESTE,5478,1992,3486
3164605,SÃO SEBASTIÃO DO OESTE,MG,SUDESTE,5097,2498,2599
3164704,SÃO SEBASTIÃO DO PARAÍSO,MG,SUDESTE,36843,20627,16216
3164803,SÃO SEBASTIÃO DO RIO PRETO,MG,SUDESTE,1289,573,716
3164902,SÃO SEBASTIÃO DO RIO VERDE,MG,SUDESTE,1690,1036,654
3165008,SÃO TIAGO,MG,SUDESTE,7006,3242,3764
3165107,SÃO TOMÁS DE AQUINO,MG,SUDESTE,4346,2287,2059
3165206,SÃO THOMÉ DAS LETRAS,MG,SUDESTE,3849,1161,2688
3165305,SÃO VICENTE DE MINAS,MG,SUDESTE,4297,1937,2360
3165404,SAPUCAÍ-MIRIM,MG,SUDESTE,4157,2273,1884
3165503,SARDOÁ,MG,SUDESTE,3151,1296,1855
3165537,SARZEDO,MG,SUDESTE,20014,11201,8813
3165552,SETUBINHA,MG,SUDESTE,5630,1131,4499
3165560,SEM-PEIXE,MG,SUDESTE,2401,722,1679
3165578,SENADOR AMARAL,MG,SUDESTE,4353,2559,1794
3165602,SENADOR CORTES,MG,SUDESTE,1888,713,1175
3165701,SENADOR FIRMINO,MG,SUDESTE,5132,1613,3519
3165800,SENADOR JOSÉ BENTO,MG,SUDESTE,1747,1034,713
3165909,SENADOR MODESTINO GONÇALVES,MG,SUDESTE,3001,869,2132
3166006,SENHORA DE OLIVEIRA,MG,SUDESTE,4283,1144,3139
3166105,SENHORA DO PORTO,MG,SUDESTE,2212,773,1439
3166204,SENHORA DOS REMÉDIOS,MG,SUDESTE,6510,2196,4314
3166303,SERICITA,MG,SUDESTE,5179,2666,2513
3166402,SERITINGA,MG,SUDESTE,1435,591,844
3166501,SERRA AZUL DE MINAS,MG,SUDESTE,2198,556,1642
3166600,SERRA DA SAUDADE,MG,SUDESTE,819,441,378
3166709,SERRA DOS AIMORÉS,MG,SUDESTE,4017,1480,2537
3166808,SERRA DO SALITRE,MG,SUDESTE,7170,4002,3168
3166907,SERRANIA,MG,SUDESTE,4786,2315,2471
3166956,SERRANÓPOLIS DE MINAS,MG,SUDESTE,2990,841,2149
3167004,SERRANOS,MG,SUDESTE,1586,653,933
3167103,SERRO,MG,SUDESTE,11214,2933,8281
3167202,SETE LAGOAS,MG,SUDESTE,135046,78922,56124
3167301,SILVEIRÂNIA,MG,SUDESTE,2104,671,1433
3167400,SILVIANÓPOLIS,MG,SUDESTE,3700,2136,1564
3167509,SIMÃO PEREIRA,MG,SUDESTE,2390,1008,1382
3167608,SIMONÉSIA,MG,SUDESTE,11903,5923,5980
3167707,SOBRÁLIA,MG,SUDESTE,3109,1466,1643
3167806,SOLEDADE DE MINAS,MG,SUDESTE,3917,2088,1829
3167905,TABULEIRO,MG,SUDESTE,3204,1231,1973
3168002,TAIOBEIRAS,MG,SUDESTE,19466,11252,8214
3168051,TAPARUBA,MG,SUDESTE,2773,1137,1636
3168101,TAPIRA,MG,SUDESTE,3560,2587,973
3168200,TAPIRAÍ,MG,SUDESTE,1480,712,768
3168309,TAQUARAÇU DE MINAS,MG,SUDESTE,3654,1900,1754
3168408,TARUMIRIM,MG,SUDESTE,7508,3600,3908
3168507,TEIXEIRAS,MG,SUDESTE,8084,2769,5315
3168606,TEÓFILO OTONI,MG,SUDESTE,75635,37683,37952
3168705,TIMÓTEO,MG,SUDESTE,46080,27644,18436
3168804,TIRADENTES,MG,SUDESTE,5554,2605,2949
3168903,TIROS,MG,SUDESTE,4364,2916,1448
3169000,TOCANTINS,MG,SUDESTE,10373,4883,5490
3169059,TOCOS DO MOJI,MG,SUDESTE,3230,1482,1748
3169109,TOLEDO,MG,SUDESTE,4867,2980,1887
3169208,TOMBOS,MG,SUDESTE,5431,2330,3101
3169307,TRÊS CORAÇÕES,MG,SUDESTE,42804,25622,17182
3169356,TRÊS MARIAS,MG,SUDESTE,17653,9018,8635
3169406,TRÊS PONTAS,MG,SUDESTE,35258,16946,18312
3169505,TUMIRITINGA,MG,SUDESTE,3806,1673,2133
3169604,TUPACIGUARA,MG,SUDESTE,15370,6980,8390
3169703,TURMALINA,MG,SUDESTE,11904,3481,8423
3169802,TURVOLÂNDIA,MG,SUDESTE,3472,1801,1671
3169901,UBÁ,MG,SUDESTE,55770,27156,28614
3170008,UBAÍ,MG,SUDESTE,6529,1542,4987
3170057,UBAPORANGA,MG,SUDESTE,7796,4453,3343
3170107,UBERABA,MG,SUDESTE,182467,98568,83899
3170206,UBERLÂNDIA,MG,SUDESTE,405959,215660,190299
3170305,UMBURATIBA,MG,SUDESTE,1782,497,1285
3170404,UNAÍ,MG,SUDESTE,48237,28970,19267
3170438,UNIÃO DE MINAS,MG,SUDESTE,2436,958,1478
3170479,URUANA DE MINAS,MG,SUDESTE,2510,1194,1316
3170503,URUCÂNIA,MG,SUDESTE,6490,2283,4207
3170529,URUCUIA,MG,SUDESTE,5303,1927,3376
3170578,VARGEM ALEGRE,MG,SUDESTE,4288,1967,2321
3170602,VARGEM BONITA,MG,SUDESTE,1912,1147,765
3170651,VARGEM GRANDE DO RIO PARDO,MG,SUDESTE,3064,1595,1469
3170701,VARGINHA,MG,SUDESTE,80561,48730,31831
3170750,VARJÃO DE MINAS,MG,SUDESTE,5026,2433,2593
3170800,VÁRZEA DA PALMA,MG,SUDESTE,19214,8923,10291
3170909,VARZELÂNDIA,MG,SUDESTE,10719,2644,8075
3171006,VAZANTE,MG,SUDESTE,12343,5850,6493
3171030,VERDELÂNDIA,MG,SUDESTE,4711,1213,3498
3171071,VEREDINHA,MG,SUDESTE,3656,964,2692
3171105,VERÍSSIMO,MG,SUDESTE,2238,968,1270
3171154,VERMELHO NOVO,MG,SUDESTE,3694,1648,2046
3171204,VESPASIANO,MG,SUDESTE,69013,35946,33067
3171303,VIÇOSA,MG,SUDESTE,47237,31871,15366
3171402,VIEIRAS,MG,SUDESTE,3016,1294,1722
3171501,MATHIAS LOBATO,MG,SUDESTE,2282,868,1414
3171600,VIRGEM DA LAPA,MG,SUDESTE,6487,1865,4622
3171709,VIRGÍNIA,MG,SUDESTE,5762,2698,3064
3171808,VIRGINÓPOLIS,MG,SUDESTE,5797,1927,3870
3171907,VIRGOLÂNDIA,MG,SUDESTE,3078,833,2245
3172004,VISCONDE DO RIO BRANCO,MG,SUDESTE,23815,10147,13668
3172103,VOLTA GRANDE,MG,SUDESTE,3047,1099,1948
3172202,WENCESLAU BRAZ,MG,SUDESTE,2059,1165,894
3200102,AFONSO CLÁUDIO,ES,SUDESTE,17545,10904,6641
3200136,ÁGUIA BRANCA,ES,SUDESTE,6513,2732,3781
3200169,ÁGUA DOCE DO NORTE,ES,SUDESTE,7525,3572,3953
3200201,ALEGRE,ES,SUDESTE,17474,9391,8083
3200300,ALFREDO CHAVES,ES,SUDESTE,9373,6446,2927
3200359,ALTO RIO NOVO,ES,SUDESTE,4400,1988,2412
3200409,ANCHIETA,ES,SUDESTE,17954,10535,7419
3200508,APIACÁ,ES,SUDESTE,4528,2356,2172
3200607,ARACRUZ,ES,SUDESTE,53611,30692,22919
3200706,ATÍLIO VIVACQUA,ES,SUDESTE,6936,3806,3130
3200805,BAIXO GUANDU,ES,SUDESTE,17646,10069,7577
3200904,BARRA DE SÃO FRANCISCO,ES,SUDESTE,23646,12950,10696
3201001,BOA ESPERANÇA,ES,SUDESTE,8156,3835,4321
3201100,BOM JESUS DO NORTE,ES,SUDESTE,5718,3041,2677
3201159,BREJETUBA,ES,SUDESTE,7090,4149,2941
3201209,CACHOEIRO DE ITAPEMIRIM,ES,SUDESTE,108519,75317,33202
3201308,CARIACICA,ES,SUDESTE,206951,116698,90253
3201407,CASTELO,ES,SUDESTE,22558,16659,5899
3201506,COLATINA,ES,SUDESTE,69606,44230,25376
3201605,CONCEIÇÃO DA BARRA,ES,SUDESTE,15523,5815,9708
3201704,CONCEIÇÃO DO CASTELO,ES,SUDESTE,7296,5128,2168
3201803,DIVINO DE SÃO LOURENÇO,ES,SUDESTE,3289,1990,1299
3201902,DOMINGOS MARTINS,ES,SUDESTE,22411,15544,6867
3202009,DORES DO RIO PRETO,ES,SUDESTE,4674,2660,2014
3202108,ECOPORANGA,ES,SUDESTE,13628,5857,7771
3202207,FUNDÃO,ES,SUDESTE,10554,5434,5120
3202256,GOVERNADOR LINDENBERG,ES,SUDESTE,6611,3332,3279
3202306,GUAÇUÍ,ES,SUDESTE,15892,9454,6438
3202405,GUARAPARI,ES,SUDESTE,70728,46347,24381
3202454,IBATIBA,ES,SUDESTE,14554,10089,4465
3202504,IBIRAÇU,ES,SUDESTE,7176,4193,2983
3202553,IBITIRAMA,ES,SUDESTE,5511,3783,1728
3202603,ICONHA,ES,SUDESTE,8761,5492,3269
3202652,IRUPI,ES,SUDESTE,8253,5903,2350
3202702,ITAGUAÇU,ES,SUDESTE,8525,4824,3701
3202801,ITAPEMIRIM,ES,SUDESTE,27000,18496,8504
3202900,ITARANA,ES,SUDESTE,7090,4569,2521
3203007,IÚNA,ES,SUDESTE,15585,10893,4692
3203056,JAGUARÉ,ES,SUDESTE,16629,6826,9803
3203106,JERÔNIMO MONTEIRO,ES,SUDESTE,7272,4045,3227
3203130,JOÃO NEIVA,ES,SUDESTE,9820,5887,3933
3203163,LARANJA DA TERRA,ES,SUDESTE,7412,4614,2798
3203205,LINHARES,ES,SUDESTE,86365,53237,33128
3203304,MANTENÓPOLIS,ES,SUDESTE,7322,4111,3211
3203320,MARATAÍZES,ES,SUDESTE,23667,15978,7689
3203346,MARECHAL FLORIANO,ES,SUDESTE,10340,6489,3851
3203353,MARILÂNDIA,ES,SUDESTE,8341,5277,3064
3203403,MIMOSO DO SUL,ES,SUDESTE,15164,7351,7813
3203502,MONTANHA,ES,SUDESTE,10560,4805,5755
3203601,MUCURICI,ES,SUDESTE,3687,1352,2335
3203700,MUNIZ FREIRE,ES,SUDESTE,10585,5907,4678
3203809,MUQUI,ES,SUDESTE,8567,4650,3917
3203908,NOVA VENÉCIA,ES,SUDESTE,28146,14891,13255
3204005,PANCAS,ES,SUDESTE,10861,5835,5026
3204054,PEDRO CANÁRIO,ES,SUDESTE,12466,5170,7296
3204104,PINHEIROS,ES,SUDESTE,13244,5180,8064
3204203,PIÚMA,ES,SUDESTE,12565,7657,4908
3204252,PONTO BELO,ES,SUDESTE,4570,1614,2956
3204302,PRESIDENTE KENNEDY,ES,SUDESTE,9521,6043,3478
3204351,RIO BANANAL,ES,SUDESTE,11403,6282,5121
3204401,RIO NOVO DO SUL,ES,SUDESTE,7057,5074,1983
3204500,SANTA LEOPOLDINA,ES,SUDESTE,7626,4046,3580
3204559,SANTA MARIA DE JETIBÁ,ES,SUDESTE,23717,16385,7332
3204609,SANTA TERESA,ES,SUDESTE,14713,9561,5152
3204658,SÃO DOMINGOS DO NORTE,ES,SUDESTE,5971,3036,2935
3204708,SÃO GABRIEL DA PALHA,ES,SUDESTE,18333,10467,7866
3204807,SÃO JOSÉ DO CALÇADO,ES,SUDESTE,6558,3131,3427
3204906,SÃO MATEUS,ES,SUDESTE,63674,30656,33018
3204955,SÃO ROQUE DO CANAÃ,ES,SUDESTE,7520,4459,3061
3205002,SERRA,ES,SUDESTE,263677,140048,123629
3205010,SOORETAMA,ES,SUDESTE,14323,7205,7118
3205036,VARGEM ALTA,ES,SUDESTE,12184,8685,3499
3205069,VENDA NOVA DO IMIGRANTE,ES,SUDESTE,14292,10610,3682
3205101,VIANA,ES,SUDESTE,39937,22027,17910
3205150,VILA PAVÃO,ES,SUDESTE,5889,2788,3101
3205176,VILA VALÉRIO,ES,SUDESTE,9550,4367,5183
3205200,VILA VELHA,ES,SUDESTE,265803,161933,103870
3205309,VITÓRIA,ES,SUDESTE,210771,115293,95478
3300100,ANGRA DOS REIS,RJ,SUDESTE,98537,65638,32899
3300159,APERIBÉ,RJ,SUDESTE,7729,4567,3162
3300209,ARARUAMA,RJ,SUDESTE,75558,51201,24357
3300225,AREAL,RJ,SUDESTE,7561,4454,3107
3300233,ARMAÇÃO DOS BÚZIOS,RJ,SUDESTE,24445,16125,8320
3300258,ARRAIAL DO CABO,RJ,SUDESTE,23490,15062,8428
3300308,BARRA DO PIRAÍ,RJ,SUDESTE,52015,25999,26016
3300407,BARRA MANSA,RJ,SUDESTE,103705,56219,47486
3300456,BELFORD ROXO,RJ,SUDESTE,257599,155071,102528
3300506,BOM JARDIM,RJ,SUDESTE,16734,9485,7249
3300605,BOM JESUS DO ITABAPOANA,RJ,SUDESTE,22488,12649,9839
3300704,CABO FRIO,RJ,SUDESTE,122041,81373,40668
3300803,CACHOEIRAS DE MACACU,RJ,SUDESTE,34263,20933,13330
3300902,CAMBUCI,RJ,SUDESTE,9505,4712,4793
3300936,CARAPEBUS,RJ,SUDESTE,9658,5433,4225
3300951,COMENDADOR LEVY GASPARIAN,RJ,SUDESTE,6506,2675,3831
3301009,CAMPOS DOS GOYTACAZES,RJ,SUDESTE,272426,171999,100427
3301108,CANTAGALO,RJ,SUDESTE,12043,5613,6430
3301157,CARDOSO MOREIRA,RJ,SUDESTE,8928,5463,3465
3301207,CARMO,RJ,SUDESTE,11364,5156,6208
3301306,CASIMIRO DE ABREU,RJ,SUDESTE,25016,16803,8213
3301405,CONCEIÇÃO DE MACABU,RJ,SUDESTE,13212,6336,6876
3301504,CORDEIRO,RJ,SUDESTE,13106,7124,5982
3301603,DUAS BARRAS,RJ,SUDESTE,7705,3780,3925
3301702,DUQUE DE CAXIAS,RJ,SUDESTE,513119,299197,213922
3301801,ENGENHEIRO PAULO DE FRONTIN,RJ,SUDESTE,8612,4344,4268
3301850,GUAPIMIRIM,RJ,SUDESTE,31677,19328,12349
3301876,IGUABA GRANDE,RJ,SUDESTE,20219,13766,6453
3301900,ITABORAÍ,RJ,SUDESTE,132804,76938,55866
3302007,ITAGUAÍ,RJ,SUDESTE,71316,45882,25434
3302056,ITALVA,RJ,SUDESTE,8749,5676,3073
3302106,ITAOCARA,RJ,SUDESTE,15384,10047,5337
3302205,ITAPERUNA,RJ,SUDESTE,56322,36755,19567
3302254,ITATIAIA,RJ,SUDESTE,19566,11288,8278
3302270,JAPERI,RJ,SUDESTE,56035,32666,23369
3302304,LAJE DO MURIAÉ,RJ,SUDESTE,5494,2225,3269
3302403,MACAÉ,RJ,SUDESTE,127128,69114,58014
3302452,MACUCO,RJ,SUDESTE,5570,2722,2848
3302502,MAGÉ,RJ,SUDESTE,149616,89784,59832
3302601,MANGARATIBA,RJ,SUDESTE,28126,17984,10142
3302700,MARICÁ,RJ,SUDESTE,112016,57955,54061
3302809,MENDES,RJ,SUDESTE,11692,5969,5723
3302858,MESQUITA,RJ,SUDESTE,103472,63809,39663
3302908,MIGUEL PEREIRA,RJ,SUDESTE,17988,10451,7537
3303005,MIRACEMA,RJ,SUDESTE,16672,7734,8938
3303104,NATIVIDADE,RJ,SUDESTE,9521,4912,4609
3303203,NILÓPOLIS,RJ,SUDESTE,99483,60276,39207
3303302,NITERÓI,RJ,SUDESTE,318068,155186,162882
3303401,NOVA FRIBURGO,RJ,SUDESTE,115032,68371,46661
3303500,NOVA IGUAÇU,RJ,SUDESTE,463584,291907,171677
3303609,PARACAMBI,RJ,SUDESTE,25788,15528,10260
3303708,PARAÍBA DO SUL,RJ,SUDESTE,25224,14086,11138
3303807,PARATY,RJ,SUDESTE,24415,15329,9086
3303856,PATY DO ALFERES,RJ,SUDESTE,17651,11062,6589
3303906,PETRÓPOLIS,RJ,SUDESTE,177984,110803,67181
3303955,PINHEIRAL,RJ,SUDESTE,13944,6402,7542
3304003,PIRAÍ,RJ,SUDESTE,17320,8935,8385
3304102,PORCIÚNCULA,RJ,SUDESTE,10221,4711,5510
3304110,PORTO REAL,RJ,SUDESTE,13808,7838,5970
3304128,QUATIS,RJ,SUDESTE,8528,4239,4289
3304144,QUEIMADOS,RJ,SUDESTE,77284,45518,31766
3304151,QUISSAMÃ,RJ,SUDESTE,14473,6928,7545
3304201,RESENDE,RJ,SUDESTE,72316,44732,27584
3304300,RIO BONITO,RJ,SUDESTE,34815,22691,12124
3304409,RIO CLARO,RJ,SUDESTE,11662,5673,5989
3304508,RIO DAS FLORES,RJ,SUDESTE,6540,2309,4231
3304524,RIO DAS OSTRAS,RJ,SUDESTE,70995,45528,25467
3304557,RIO DE JANEIRO,RJ,SUDESTE,3663368,1929209,1734159
3304607,SANTA MARIA MADALENA,RJ,SUDESTE,6650,3226,3424
3304706,SANTO ANTÔNIO DE PÁDUA,RJ,SUDESTE,24609,14919,9690
3304755,SÃO FRANCISCO DE ITABAPOANA,RJ,SUDESTE,27160,18184,8976
3304805,SÃO FIDÉLIS,RJ,SUDESTE,23172,14649,8523
3304904,SÃO GONÇALO,RJ,SUDESTE,499564,276870,222694
3305000,SÃO JOÃO DA BARRA,RJ,SUDESTE,28970,17577,11393
3305109,SÃO JOÃO DE MERITI,RJ,SUDESTE,281265,168876,112389
3305133,SÃO JOSÉ DE UBÁ,RJ,SUDESTE,5800,3523,2277
3305158,SÃO JOSÉ DO VALE DO RIO PRETO,RJ,SUDESTE,12950,10120,2830
3305208,SÃO PEDRO DA ALDEIA,RJ,SUDESTE,52194,37646,14548
3305307,SÃO SEBASTIÃO DO ALTO,RJ,SUDESTE,5928,3251,2677
3305406,SAPUCAIA,RJ,SUDESTE,12576,7144,5432
3305505,SAQUAREMA,RJ,SUDESTE,54724,35630,19094
3305554,SEROPÉDICA,RJ,SUDESTE,44386,27546,16840
3305604,SILVA JARDIM,RJ,SUDESTE,14295,8843,5452
3305703,SUMIDOURO,RJ,SUDESTE,11426,7347,4079
3305752,TANGUÁ,RJ,SUDESTE,19771,11461,8310
3305802,TERESÓPOLIS,RJ,SUDESTE,97495,66230,31265
3305901,TRAJANO DE MORAES,RJ,SUDESTE,6855,3184,3671
3306008,TRÊS RIOS,RJ,SUDESTE,48014,22574,25440
3306107,VALENÇA,RJ,SUDESTE,41252,17591,23661
3306156,VARRE-SAI,RJ,SUDESTE,6675,4236,2439
3306206,VASSOURAS,RJ,SUDESTE,22351,11398,10953
3306305,VOLTA REDONDA,RJ,SUDESTE,172794,91375,81419
3500105,ADAMANTINA,SP,SUDESTE,20059,14937,5122
3500204,ADOLFO,SP,SUDESTE,3118,2005,1113
3500303,AGUAÍ,SP,SUDESTE,17333,10429,6904
3500402,ÁGUAS DA PRATA,SP,SUDESTE,4652,2902,1750
3500501,ÁGUAS DE LINDÓIA,SP,SUDESTE,11133,7991,3142
3500550,ÁGUAS DE SANTA BÁRBARA,SP,SUDESTE,3747,2464,1283
3500600,ÁGUAS DE SÃO PEDRO,SP,SUDESTE,2985,2024,961
3500709,AGUDOS,SP,SUDESTE,21947,14648,7299
3500758,ALAMBARI,SP,SUDESTE,3819,2512,1307
3500808,ALFREDO MARCONDES,SP,SUDESTE,3104,1914,1190
3500907,ALTAIR,SP,SUDESTE,2364,1327,1037
3501004,ALTINÓPOLIS,SP,SUDESTE,9533,5136,4397
3501103,ALTO ALEGRE,SP,SUDESTE,2772,1874,898
3501152,ALUMÍNIO,SP,SUDESTE,10883,5756,5127
3501202,ÁLVARES FLORENCE,SP,SUDESTE,2856,1872,984
3501301,ÁLVARES MACHADO,SP,SUDESTE,14389,8665,5724
3501400,ÁLVARO DE CARVALHO,SP,SUDESTE,2111,1094,1017
3501509,ALVINLÂNDIA,SP,SUDESTE,2031,1074,957
3501608,AMERICANA,SP,SUDESTE,137936,92771,45165
3501707,AMÉRICO BRASILIENSE,SP,SUDESTE,21278,9600,11678
3501806,AMÉRICO DE CAMPOS,SP,SUDESTE,3892,2481,1411
3501905,AMPARO,SP,SUDESTE,41476,28122,13354
3502002,ANALÂNDIA,SP,SUDESTE,2976,1984,992
3502101,ANDRADINA,SP,SUDESTE,33529,21248,12281
3502200,ANGATUBA,SP,SUDESTE,13109,7310,5799
3502309,ANHEMBI,SP,SUDESTE,3813,2315,1498
3502408,ANHUMAS,SP,SUDESTE,2598,1547,1051
3502507,APARECIDA,SP,SUDESTE,21880,13761,8119
3502606,APARECIDA D'OESTE,SP,SUDESTE,2953,1544,1409
3502705,APIAÍ,SP,SUDESTE,13837,7376,6461
3502754,ARAÇARIGUAMA,SP,SUDESTE,12551,7198,5353
3502804,ARAÇATUBA,SP,SUDESTE,115093,79700,35393
3502903,ARAÇOIABA DA SERRA,SP,SUDESTE,19119,12602,6517
3503000,ARAMINA,SP,SUDESTE,3442,1682,1760
3503109,ARANDU,SP,SUDESTE,4265,2523,1742
3503158,ARAPEÍ,SP,SUDESTE,1794,872,922
3503208,ARARAQUARA,SP,SUDESTE,131457,65076,66381
3503307,ARARAS,SP,SUDESTE,76212,52074,24138
3503356,ARCO-ÍRIS,SP,SUDESTE,1697,1065,632
3503406,AREALVA,SP,SUDESTE,4775,3129,1646
3503505,AREIAS,SP,SUDESTE,2533,946,1587
3503604,AREIÓPOLIS,SP,SUDESTE,6383,3515,2868
3503703,ARIRANHA,SP,SUDESTE,5208,3307,1901
3503802,ARTUR NOGUEIRA,SP,SUDESTE,29911,18979,10932
3503901,ARUJÁ,SP,SUDESTE,53512,30665,22847
3503950,ASPÁSIA,SP,SUDESTE,1473,858,615
3504008,ASSIS,SP,SUDESTE,54231,33844,20387
3504107,ATIBAIA,SP,SUDESTE,88269,56255,32014
3504206,AURIFLAMA,SP,SUDESTE,8617,5760,2857
3504305,AVAÍ,SP,SUDESTE,3027,1500,1527
3504404,AVANHANDAVA,SP,SUDESTE,5793,2942,2851
3504503,AVARÉ,SP,SUDESTE,48419,30775,17644
3504602,BADY BASSITT,SP,SUDESTE,11048,7638,3410
3504701,BALBINOS,SP,SUDESTE,1081,639,442
3504800,BÁLSAMO,SP,SUDESTE,5802,3883,1919
3504909,BANANAL,SP,SUDESTE,6348,2837,3511
3505005,BARÃO DE ANTONINA,SP,SUDESTE,2024,993,1031
3505104,BARBOSA,SP,SUDESTE,3881,2237,1644
3505203,BARIRI,SP,SUDESTE,17807,12760,5047
3505302,BARRA BONITA,SP,SUDESTE,22342,14684,7658
3505351,BARRA DO CHAPÉU,SP,SUDESTE,3465,1727,1738
3505401,BARRA DO TURVO,SP,SUDESTE,4401,2162,2239
3505500,BARRETOS,SP,SUDESTE,64305,40384,23921
3505609,BARRINHA,SP,SUDESTE,18647,9041,9606
3505708,BARUERI,SP,SUDESTE,212684,109971,102713
3505807,BASTOS,SP,SUDESTE,13263,9478,3785
3505906,BATATAIS,SP,SUDESTE,32748,18531,14217
3506003,BAURU,SP,SUDESTE,205714,125569,80145
3506102,BEBEDOURO,SP,SUDESTE,43436,29911,13525
3506201,BENTO DE ABREU,SP,SUDESTE,1672,983,689
3506300,BERNARDINO DE CAMPOS,SP,SUDESTE,6135,3835,2300
3506359,BERTIOGA,SP,SUDESTE,34598,19594,15004
3506409,BILAC,SP,SUDESTE,4901,3416,1485
3506508,BIRIGUI,SP,SUDESTE,67146,49166,17980
3506607,BIRITIBA-MIRIM,SP,SUDESTE,17355,10445,6910
3506706,BOA ESPERANÇA DO SUL,SP,SUDESTE,7673,3242,4431
3506805,BOCAINA,SP,SUDESTE,6722,4517,2205
3506904,BOFETE,SP,SUDESTE,5809,3523,2286
3507001,BOITUVA,SP,SUDESTE,33856,22432,11424
3507100,BOM JESUS DOS PERDÕES,SP,SUDESTE,13716,8551,5165
3507159,BOM SUCESSO DE ITARARÉ,SP,SUDESTE,2505,1121,1384
3507209,BORÁ,SP,SUDESTE,790,460,330
3507308,BORACÉIA,SP,SUDESTE,2950,1724,1226
3507407,BORBOREMA,SP,SUDESTE,8451,5749,2702
3507456,BOREBI,SP,SUDESTE,1678,977,701
3507506,BOTUCATU,SP,SUDESTE,81376,47560,33816
3507605,BRAGANÇA PAULISTA,SP,SUDESTE,99835,66832,33003
3507704,BRAÚNA,SP,SUDESTE,3305,2275,1030
3507753,BREJO ALEGRE,SP,SUDESTE,1942,898,1044
3507803,BRODOWSKI,SP,SUDESTE,13710,9320,4390
3507902,BROTAS,SP,SUDESTE,13259,9188,4071
3508009,BURI,SP,SUDESTE,11514,6963,4551
3508108,BURITAMA,SP,SUDESTE,9871,6327,3544
3508207,BURITIZAL,SP,SUDESTE,2941,2024,917
3508306,CABRÁLIA PAULISTA,SP,SUDESTE,2557,1329,1228
3508405,CABREÚVA,SP,SUDESTE,26650,16677,9973
3508504,CAÇAPAVA,SP,SUDESTE,55619,36878,18741
3508603,CACHOEIRA PAULISTA,SP,SUDESTE,18588,10952,7636
3508702,CACONDE,SP,SUDESTE,10320,5774,4546
3508801,CAFELÂNDIA,SP,SUDESTE,9457,5912,3545
3508900,CAIABU,SP,SUDESTE,2705,1367,1338
3509007,CAIEIRAS,SP,SUDESTE,53908,27747,26161
3509106,CAIUÁ,SP,SUDESTE,2903,1264,1639
3509205,CAJAMAR,SP,SUDESTE,51212,26060,25152
3509254,CAJATI,SP,SUDESTE,16431,10938,5493
3509304,CAJOBI,SP,SUDESTE,5896,3621,2275
3509403,CAJURU,SP,SUDESTE,13889,7268,6621
3509452,CAMPINA DO MONTE ALEGRE,SP,SUDESTE,3672,2212,1460
3509502,CAMPINAS,SP,SUDESTE,655030,368251,286779
3509601,CAMPO LIMPO PAULISTA,SP,SUDESTE,45359,26382,18977
3509700,CAMPOS DO JORDÃO,SP,SUDESTE,28051,17558,10493
3509809,CAMPOS NOVOS PAULISTA,SP,SUDESTE,2828,1757,1071
3509908,CANANÉIA,SP,SUDESTE,7247,4150,3097
3509957,CANAS,SP,SUDESTE,2961,1774,1187
3510005,CÂNDIDO MOTA,SP,SUDESTE,18007,12459,5548
3510104,CÂNDIDO RODRIGUES,SP,SUDESTE,1928,1292,636
3510153,CANITAR,SP,SUDESTE,2965,1578,1387
3510203,CAPÃO BONITO,SP,SUDESTE,26069,15942,10127
3510302,CAPELA DO ALTO,SP,SUDESTE,11183,7544,3639
3510401,CAPIVARI,SP,SUDESTE,29458,20135,9323
3510500,CARAGUATATUBA,SP,SUDESTE,75911,45092,30819
3510609,CARAPICUÍBA,SP,SUDESTE,222280,103403,118877
3510708,CARDOSO,SP,SUDESTE,6978,3831,3147
3510807,CASA BRANCA,SP,SUDESTE,14690,9789,4901
3510906,CÁSSIA DOS COQUEIROS,SP,SUDESTE,2002,1058,944
3511003,CASTILHO,SP,SUDESTE,11678,5158,6520
3511102,CATANDUVA,SP,SUDESTE,66511,46210,20301
3511201,CATIGUÁ,SP,SUDESTE,4442,2945,1497
3511300,CEDRAL,SP,SUDESTE,5971,4274,1697
3511409,CERQUEIRA CÉSAR,SP,SUDESTE,10918,6545,4373
3511508,CERQUILHO,SP,SUDESTE,26955,19447,7508
3511607,CESÁRIO LANGE,SP,SUDESTE,9773,6841,2932
3511706,CHARQUEADA,SP,SUDESTE,10043,7009,3034
3511904,CLEMENTINA,SP,SUDESTE,4271,2743,1528
3512001,COLINA,SP,SUDESTE,10819,5794,5025
3512100,COLÔMBIA,SP,SUDESTE,4153,2172,1981
3512209,CONCHAL,SP,SUDESTE,17043,12369,4674
3512308,CONCHAS,SP,SUDESTE,9586,6706,2880
3512407,CORDEIRÓPOLIS,SP,SUDESTE,15104,10004,5100
3512506,COROADOS,SP,SUDESTE,3252,2239,1013
3512605,CORONEL MACEDO,SP,SUDESTE,2984,1144,1840
3512704,CORUMBATAÍ,SP,SUDESTE,2589,1826,763
3512803,COSMÓPOLIS,SP,SUDESTE,34029,19757,14272
3512902,COSMORAMA,SP,SUDESTE,5503,3443,2060
3513009,COTIA,SP,SUDESTE,140668,69121,71547
3513108,CRAVINHOS,SP,SUDESTE,19657,13162,6495
3513207,CRISTAIS PAULISTA,SP,SUDESTE,5613,3287,2326
3513306,CRUZÁLIA,SP,SUDESTE,1602,1033,569
3513405,CRUZEIRO,SP,SUDESTE,43893,26115,17778
3513504,CUBATÃO,SP,SUDESTE,70191,33610,36581
3513603,CUNHA,SP,SUDESTE,13687,7493,6194
3513702,DESCALVADO,SP,SUDESTE,18197,12497,5700
3513801,DIADEMA,SP,SUDESTE,257228,102841,154387
3513850,DIRCE REIS,SP,SUDESTE,1232,642,590
3513900,DIVINOLÂNDIA,SP,SUDESTE,7328,4948,2380
3514007,DOBRADA,SP,SUDESTE,4976,2202,2774
3514106,DOIS CÓRREGOS,SP,SUDESTE,13853,9161,4692
3514205,DOLCINÓPOLIS,SP,SUDESTE,1680,659,1021
3514304,DOURADO,SP,SUDESTE,5202,2961,2241
3514403,DRACENA,SP,SUDESTE,25943,18374,7569
3514502,DUARTINA,SP,SUDESTE,7634,4488,3146
3514601,DUMONT,SP,SUDESTE,5547,3551,1996
3514700,ECHAPORÃ,SP,SUDESTE,3897,2460,1437
3514809,ELDORADO,SP,SUDESTE,8035,4352,3683
3514908,ELIAS FAUSTO,SP,SUDESTE,10618,7196,3422
3514924,ELISIÁRIO,SP,SUDESTE,2137,1440,697
3514957,EMBAÚBA,SP,SUDESTE,1851,1090,761
3515004,EMBU DAS ARTES,SP,SUDESTE,154307,66009,88298
3515103,EMBU-GUAÇU,SP,SUDESTE,39489,19410,20079
3515129,EMILIANÓPOLIS,SP,SUDESTE,2152,1109,1043
3515152,ENGENHEIRO COELHO,SP,SUDESTE,11168,7101,4067
3515186,ESPÍRITO SANTO DO PINHAL,SP,SUDESTE,23752,15006,8746
3515194,ESPÍRITO SANTO DO TURVO,SP,SUDESTE,2542,1344,1198
3515202,ESTRELA D'OESTE,SP,SUDESTE,5377,3570,1807
3515301,ESTRELA DO NORTE,SP,SUDESTE,1925,863,1062
3515350,EUCLIDES DA CUNHA PAULISTA,SP,SUDESTE,4726,1709,3017
3515400,FARTURA,SP,SUDESTE,9621,5145,4476
3515509,FERNANDÓPOLIS,SP,SUDESTE,39197,24566,14631
3515608,FERNANDO PRESTES,SP,SUDESTE,3739,2474,1265
3515657,FERNÃO,SP,SUDESTE,1178,772,406
3515707,FERRAZ DE VASCONCELOS,SP,SUDESTE,99669,44398,55271
3515806,FLORA RICA,SP,SUDESTE,1131,576,555
3515905,FLOREAL,SP,SUDESTE,2053,1145,908
3516002,FLÓRIDA PAULISTA,SP,SUDESTE,5986,3740,2246
3516101,FLORÍNIA,SP,SUDESTE,2018,1002,1016
3516200,FRANCA,SP,SUDESTE,187399,119713,67686
3516309,FRANCISCO MORATO,SP,SUDESTE,96364,38789,57575
3516408,FRANCO DA ROCHA,SP,SUDESTE,77459,35285,42174
3516507,GABRIEL MONTEIRO,SP,SUDESTE,2028,1413,615
3516606,GÁLIA,SP,SUDESTE,3736,1844,1892
3516705,GARÇA,SP,SUDESTE,25053,16940,8113
3516804,GASTÃO VIDIGAL,SP,SUDESTE,2250,983,1267
3516853,GAVIÃO PEIXOTO,SP,SUDESTE,3057,1292,1765
3516903,GENERAL SALGADO,SP,SUDESTE,6305,4049,2256
3517000,GETULINA,SP,SUDESTE,5402,3052,2350
3517109,GLICÉRIO,SP,SUDESTE,2894,1678,1216
3517208,GUAIÇARA,SP,SUDESTE,6159,3704,2455
3517307,GUAIMBÊ,SP,SUDESTE,3361,1760,1601
3517406,GUAÍRA,SP,SUDESTE,20811,13046,7765
3517505,GUAPIAÇU,SP,SUDESTE,11803,7508,4295
3517604,GUAPIARA,SP,SUDESTE,10572,4398,6174
3517703,GUARÁ,SP,SUDESTE,11058,5529,5529
3517802,GUARAÇAÍ,SP,SUDESTE,4868,3149,1719
3517901,GUARACI,SP,SUDESTE,6196,3042,3154
3518008,GUARANI D'OESTE,SP,SUDESTE,1322,635,687
3518107,GUARANTÃ,SP,SUDESTE,3762,2272,1490
3518206,GUARARAPES,SP,SUDESTE,18104,12126,5978
3518305,GUARAREMA,SP,SUDESTE,19187,12212,6975
3518404,GUARATINGUETÁ,SP,SUDESTE,72350,47275,25075
3518503,GUAREÍ,SP,SUDESTE,6948,4482,2466
3518602,GUARIBA,SP,SUDESTE,21961,11836,10125
3518701,GUARUJÁ,SP,SUDESTE,176041,99610,76431
3518800,GUARULHOS,SP,SUDESTE,728923,391234,337689
3518859,GUATAPARÁ,SP,SUDESTE,4331,1989,2342
3518909,GUZOLÂNDIA,SP,SUDESTE,2679,1270,1409
3519006,HERCULÂNDIA,SP,SUDESTE,5324,3230,2094
3519055,HOLAMBRA,SP,SUDESTE,9646,6492,3154
3519071,HORTOLÂNDIA,SP,SUDESTE,127205,69513,57692
3519105,IACANGA,SP,SUDESTE,6528,4254,2274
3519204,IACRI,SP,SUDESTE,3782,2505,1277
3519253,IARAS,SP,SUDESTE,2975,1379,1596
3519303,IBATÉ,SP,SUDESTE,19061,10204,8857
3519402,IBIRÁ,SP,SUDESTE,7065,4826,2239
3519501,IBIRAREMA,SP,SUDESTE,3919,2690,1229
3519600,IBITINGA,SP,SUDESTE,32487,21029,11458
3519709,IBIÚNA,SP,SUDESTE,45280,30098,15182
3519808,ICÉM,SP,SUDESTE,4704,2482,2222
3519907,IEPÊ,SP,SUDESTE,4865,2966,1899
3520004,IGARAÇU DO TIETÊ,SP,SUDESTE,13501,7998,5503
3520103,IGARAPAVA,SP,SUDESTE,14872,7446,7426
3520202,IGARATÁ,SP,SUDESTE,6652,4102,2550
3520301,IGUAPE,SP,SUDESTE,16025,9454,6571
3520400,ILHABELA,SP,SUDESTE,21672,12076,9596
3520426,ILHA COMPRIDA,SP,SUDESTE,8302,4709,3593
3520442,ILHA SOLTEIRA,SP,SUDESTE,14647,8205,6442
3520509,INDAIATUBA,SP,SUDESTE,143282,91937,51345
3520608,INDIANA,SP,SUDESTE,3215,2024,1191
3520707,INDIAPORÃ,SP,SUDESTE,2403,1214,1189
3520806,INÚBIA PAULISTA,SP,SUDESTE,2421,1753,668
3520905,IPAUSSU,SP,SUDESTE,7897,4888,3009
3521002,IPERÓ,SP,SUDESTE,15466,8039,7427
3521101,IPEÚNA,SP,SUDESTE,4233,2972,1261
3521150,IPIGUÁ,SP,SUDESTE,3321,2311,1010
3521200,IPORANGA,SP,SUDESTE,2353,1008,1345
3521309,IPUÃ,SP,SUDESTE,8885,4066,4819
3521408,IRACEMÁPOLIS,SP,SUDESTE,14244,9790,4454
3521507,IRAPUÃ,SP,SUDESTE,4193,3017,1176
3521606,IRAPURU,SP,SUDESTE,3578,2171,1407
3521705,ITABERÁ,SP,SUDESTE,10777,5754,5023
3521804,ITAÍ,SP,SUDESTE,12962,6333,6629
3521903,ITAJOBI,SP,SUDESTE,9642,7145,2497
3522000,ITAJU,SP,SUDESTE,2291,1442,849
3522109,ITANHAÉM,SP,SUDESTE,57648,31700,25948
3522158,ITAÓCA,SP,SUDESTE,2103,924,1179
3522208,ITAPECERICA DA SERRA,SP,SUDESTE,92414,39226,53188
3522307,ITAPETININGA,SP,SUDESTE,86668,58297,28371
3522406,ITAPEVA,SP,SUDESTE,52225,32952,19273
3522505,ITAPEVI,SP,SUDESTE,122212,53526,68686
3522604,ITAPIRA,SP,SUDESTE,41757,28124,13633
3522653,ITAPIRAPUÃ PAULISTA,SP,SUDESTE,2504,1088,1416
3522703,ITÁPOLIS,SP,SUDESTE,22661,15807,6854
3522802,ITAPORANGA,SP,SUDESTE,8347,4860,3487
3522901,ITAPUÍ,SP,SUDESTE,7452,4360,3092
3523008,ITAPURA,SP,SUDESTE,2499,692,1807
3523107,ITAQUAQUECETUBA,SP,SUDESTE,186528,87164,99364
3523206,ITARARÉ,SP,SUDESTE,25376,16112,9264
3523305,ITARIRI,SP,SUDESTE,6615,4042,2573
3523404,ITATIBA,SP,SUDESTE,64637,43044,21593
3523503,ITATINGA,SP,SUDESTE,10380,6165,4215
3523602,ITIRAPINA,SP,SUDESTE,7551,4461,3090
3523701,ITIRAPUÃ,SP,SUDESTE,3756,1714,2042
3523800,ITOBI,SP,SUDESTE,4623,2589,2034
3523909,ITU,SP,SUDESTE,93655,60031,33624
3524006,ITUPEVA,SP,SUDESTE,34037,21512,12525
3524105,ITUVERAVA,SP,SUDESTE,21158,12759,8399
3524204,JABORANDI,SP,SUDESTE,4060,2102,1958
3524303,JABOTICABAL,SP,SUDESTE,39317,25232,14085
3524402,JACAREÍ,SP,SUDESTE,132579,83006,49573
3524501,JACI,SP,SUDESTE,4414,2637,1777
3524600,JACUPIRANGA,SP,SUDESTE,9255,6274,2981
3524709,JAGUARIÚNA,SP,SUDESTE,33379,21568,11811
3524808,JALES,SP,SUDESTE,28422,19385,9037
3524907,JAMBEIRO,SP,SUDESTE,3770,2311,1459
3525003,JANDIRA,SP,SUDESTE,60890,29948,30942
3525102,JARDINÓPOLIS,SP,SUDESTE,21672,14171,7501
3525201,JARINU,SP,SUDESTE,19012,12076,6936
3525300,JAÚ,SP,SUDESTE,78807,56644,22163
3525409,JERIQUARA,SP,SUDESTE,2397,1140,1257
3525508,JOANÓPOLIS,SP,SUDESTE,7370,4924,2446
3525607,JOÃO RAMALHO,SP,SUDESTE,2598,1405,1193
3525706,JOSÉ BONIFÁCIO,SP,SUDESTE,21233,13915,7318
3525805,JÚLIO MESQUITA,SP,SUDESTE,2853,1286,1567
3525854,JUMIRIM,SP,SUDESTE,1798,1185,613
3525904,JUNDIAÍ,SP,SUDESTE,251435,160078,91357
3526001,JUNQUEIRÓPOLIS,SP,SUDESTE,10464,6983,3481
3526100,JUQUIÁ,SP,SUDESTE,10779,6618,4161
3526209,JUQUITIBA,SP,SUDESTE,17087,8620,8467
3526308,LAGOINHA,SP,SUDESTE,3973,2197,1776
3526407,LARANJAL PAULISTA,SP,SUDESTE,15911,11438,4473
3526506,LAVÍNIA,SP,SUDESTE,2927,1572,1355
3526605,LAVRINHAS,SP,SUDESTE,4786,2459,2327
3526704,LEME,SP,SUDESTE,56004,36488,19516
3526803,LENÇÓIS PAULISTA,SP,SUDESTE,38944,28970,9974
3526902,LIMEIRA,SP,SUDESTE,176126,129373,46753
3527009,LINDÓIA,SP,SUDESTE,4472,3162,1310
3527108,LINS,SP,SUDESTE,41387,29727,11660
3527207,LORENA,SP,SUDESTE,48459,31671,16788
3527256,LOURDES,SP,SUDESTE,1441,888,553
3527306,LOUVEIRA,SP,SUDESTE,29376,18720,10656
3527405,LUCÉLIA,SP,SUDESTE,10103,6430,3673
3527504,LUCIANÓPOLIS,SP,SUDESTE,1594,817,777
3527603,LUÍS ANTÔNIO,SP,SUDESTE,7312,3896,3416
3527702,LUIZIÂNIA,SP,SUDESTE,2967,1674,1293
3527801,LUPÉRCIO,SP,SUDESTE,2567,1362,1205
3527900,LUTÉCIA,SP,SUDESTE,1879,991,888
3528007,MACATUBA,SP,SUDESTE,10006,6871,3135
3528106,MACAUBAL,SP,SUDESTE,4690,3258,1432
3528205,MACEDÔNIA,SP,SUDESTE,2751,1669,1082
3528304,MAGDA,SP,SUDESTE,2171,1259,912
3528403,MAIRINQUE,SP,SUDESTE,29296,16238,13058
3528502,MAIRIPORÃ,SP,SUDESTE,48702,29538,19164
3528601,MANDURI,SP,SUDESTE,5422,3208,2214
3528700,MARABÁ PAULISTA,SP,SUDESTE,2228,900,1328
3528809,MARACAÍ,SP,SUDESTE,8334,5238,3096
3528858,MARAPOAMA,SP,SUDESTE,2115,1611,504
3528908,MARIÁPOLIS,SP,SUDESTE,2285,1314,971
3529005,MARÍLIA,SP,SUDESTE,134203,93172,41031
3529104,MARINÓPOLIS,SP,SUDESTE,1369,731,638
3529203,MARTINÓPOLIS,SP,SUDESTE,14064,8716,5348
3529302,MATÃO,SP,SUDESTE,49942,30481,19461
3529401,MAUÁ,SP,SUDESTE,237590,111172,126418
3529500,MENDONÇA,SP,SUDESTE,3838,2286,1552
3529609,MERIDIANO,SP,SUDESTE,2819,1643,1176
3529658,MESÓPOLIS,SP,SUDESTE,1339,759,580
3529708,MIGUELÓPOLIS,SP,SUDESTE,11477,6007,5470
3529807,MINEIROS DO TIETÊ,SP,SUDESTE,6734,4667,2067
3529906,MIRACATU,SP,SUDESTE,10994,6800,4194
3530003,MIRA ESTRELA,SP,SUDESTE,1994,1099,895
3530102,MIRANDÓPOLIS,SP,SUDESTE,13827,9487,4340
3530201,MIRANTE DO PARANAPANEMA,SP,SUDESTE,9742,4015,5727
3530300,MIRASSOL,SP,SUDESTE,33970,23095,10875
3530409,MIRASSOLÂNDIA,SP,SUDESTE,3136,2006,1130
3530508,MOCOCA,SP,SUDESTE,36968,23963,13005
3530607,MOGI DAS CRUZES,SP,SUDESTE,245153,139298,105855
3530706,MOGI GUAÇU,SP,SUDESTE,89451,62945,26506
3530805,MOGI MIRIM,SP,SUDESTE,52563,36952,15611
3530904,MOMBUCA,SP,SUDESTE,2407,1631,776
3531001,MONÇÕES,SP,SUDESTE,1550,940,610
3531100,MONGAGUÁ,SP,SUDESTE,33414,17243,16171
3531209,MONTE ALEGRE DO SUL,SP,SUDESTE,4840,3274,1566
3531308,MONTE ALTO,SP,SUDESTE,27661,19274,8387
3531407,MONTE APRAZÍVEL,SP,SUDESTE,13171,8454,4717
3531506,MONTE AZUL PAULISTA,SP,SUDESTE,10860,7177,3683
3531605,MONTE CASTELO,SP,SUDESTE,2735,1420,1315
3531704,MONTEIRO LOBATO,SP,SUDESTE,2964,1588,1376
3531803,MONTE MOR,SP,SUDESTE,34569,18971,15598
3531902,MORRO AGUDO,SP,SUDESTE,15450,8780,6670
3532009,MORUNGABA,SP,SUDESTE,8254,5558,2696
3532058,MOTUCA,SP,SUDESTE,2675,1308,1367
3532108,MURUTINGA DO SUL,SP,SUDESTE,2666,1652,1014
3532157,NANTES,SP,SUDESTE,1739,878,861
3532207,NARANDIBA,SP,SUDESTE,3453,1647,1806
3532306,NATIVIDADE DA SERRA,SP,SUDESTE,4118,2445,1673
3532405,NAZARÉ PAULISTA,SP,SUDESTE,10650,6589,4061
3532504,NEVES PAULISTA,SP,SUDESTE,5742,3500,2242
3532603,NHANDEARA,SP,SUDESTE,5968,4090,1878
3532702,NIPOÃ,SP,SUDESTE,2915,1708,1207
3532801,NOVA ALIANÇA,SP,SUDESTE,3981,2572,1409
3532827,NOVA CAMPINA,SP,SUDESTE,5348,2848,2500
3532843,NOVA CANAÃ PAULISTA,SP,SUDESTE,1449,747,702
3532868,NOVA CASTILHO,SP,SUDESTE,984,617,367
3532900,NOVA EUROPA,SP,SUDESTE,5752,2557,3195
3533007,NOVA GRANADA,SP,SUDESTE,11583,6270,5313
3533106,NOVA GUATAPORANGA,SP,SUDESTE,1500,727,773
3533205,NOVA INDEPENDÊNCIA,SP,SUDESTE,2522,1372,1150
3533254,NOVAIS,SP,SUDESTE,2789,1709,1080
3533304,NOVA LUZITÂNIA,SP,SUDESTE,2070,1005,1065
3533403,NOVA ODESSA,SP,SUDESTE,36585,22857,13728
3533502,NOVO HORIZONTE,SP,SUDESTE,21798,15093,6705
3533601,NUPORANGA,SP,SUDESTE,4518,2828,1690
3533700,OCAUÇU,SP,SUDESTE,2590,1442,1148
3533809,ÓLEO,SP,SUDESTE,1834,1163,671
3533908,OLÍMPIA,SP,SUDESTE,31710,20690,11020
3534005,ONDA VERDE,SP,SUDESTE,3142,1803,1339
3534104,ORIENTE,SP,SUDESTE,3959,2503,1456
3534203,ORINDIÚVA,SP,SUDESTE,3809,1976,1833
3534302,ORLÂNDIA,SP,SUDESTE,23014,14135,8879
3534401,OSASCO,SP,SUDESTE,441041,218756,222285
3534500,OSCAR BRESSANE,SP,SUDESTE,1874,1280,594
3534609,OSVALDO CRUZ,SP,SUDESTE,17751,12445,5306
3534708,OURINHOS,SP,SUDESTE,58830,36790,22040
3534757,OUROESTE,SP,SUDESTE,5762,3359,2403
3534807,OURO VERDE,SP,SUDESTE,4601,2325,2276
3534906,PACAEMBU,SP,SUDESTE,6081,4007,2074
3535002,PALESTINA,SP,SUDESTE,6734,4087,2647
3535101,PALMARES PAULISTA,SP,SUDESTE,6085,3250,2835
3535200,PALMEIRA D'OESTE,SP,SUDESTE,5742,3453,2289
3535309,PALMITAL,SP,SUDESTE,12685,8260,4425
3535408,PANORAMA,SP,SUDESTE,7957,4785,3172
3535507,PARAGUAÇU PAULISTA,SP,SUDESTE,23303,13739,9564
3535606,PARAIBUNA,SP,SUDESTE,10574,5446,5128
3535705,PARAÍSO,SP,SUDESTE,3578,2285,1293
3535804,PARANAPANEMA,SP,SUDESTE,10645,6046,4599
3535903,PARANAPUÃ,SP,SUDESTE,2756,1574,1182
3536000,PARAPUÃ,SP,SUDESTE,5950,3860,2090
3536109,PARDINHO,SP,SUDESTE,4158,2529,1629
3536208,PARIQUERA-AÇU,SP,SUDESTE,10960,7365,3595
3536257,PARISI,SP,SUDESTE,2088,1274,814
3536307,PATROCÍNIO PAULISTA,SP,SUDESTE,8023,4887,3136
3536406,PAULICÉIA,SP,SUDESTE,4424,2754,1670
3536505,PAULÍNIA,SP,SUDESTE,64616,38254,26362
3536570,PAULISTÂNIA,SP,SUDESTE,1403,888,515
3536604,PAULO DE FARIA,SP,SUDESTE,4589,2221,2368
3536703,PEDERNEIRAS,SP,SUDESTE,25803,17743,8060
3536802,PEDRA BELA,SP,SUDESTE,3853,2265,1588
3536901,PEDRANÓPOLIS,SP,SUDESTE,1869,1043,826
3537008,PEDREGULHO,SP,SUDESTE,9059,4145,4914
3537107,PEDREIRA,SP,SUDESTE,25818,18555,7263
3537156,PEDRINHAS PAULISTA,SP,SUDESTE,2146,1427,719
3537206,PEDRO DE TOLEDO,SP,SUDESTE,5383,2944,2439
3537305,PENÁPOLIS,SP,SUDESTE,34303,22499,11804
3537404,PEREIRA BARRETO,SP,SUDESTE,14175,8109,6066
3537503,PEREIRAS,SP,SUDESTE,4770,2807,1963
3537602,PERUÍBE,SP,SUDESTE,41455,23989,17466
3537701,PIACATU,SP,SUDESTE,3592,2240,1352
3537800,PIEDADE,SP,SUDESTE,30739,19474,11265
3537909,PILAR DO SUL,SP,SUDESTE,17253,11070,6183
3538006,PINDAMONHANGABA,SP,SUDESTE,90628,57969,32659
3538105,PINDORAMA,SP,SUDESTE,8481,5615,2866
3538204,PINHALZINHO,SP,SUDESTE,8218,5480,2738
3538303,PIQUEROBI,SP,SUDESTE,2321,1150,1171
3538501,PIQUETE,SP,SUDESTE,7626,4981,2645
3538600,PIRACAIA,SP,SUDESTE,16449,10978,5471
3538709,PIRACICABA,SP,SUDESTE,229328,155716,73612
3538808,PIRAJU,SP,SUDESTE,16789,9893,6896
3538907,PIRAJUÍ,SP,SUDESTE,11430,7453,3977
3539004,PIRANGI,SP,SUDESTE,6310,4321,1989
3539103,PIRAPORA DO BOM JESUS,SP,SUDESTE,10131,4613,5518
3539202,PIRAPOZINHO,SP,SUDESTE,15440,9216,6224
3539301,PIRASSUNUNGA,SP,SUDESTE,43040,29979,13061
3539400,PIRATININGA,SP,SUDESTE,7502,5147,2355
3539509,PITANGUEIRAS,SP,SUDESTE,19396,10554,8842
3539608,PLANALTO,SP,SUDESTE,3078,1606,1472
3539707,PLATINA,SP,SUDESTE,2043,1306,737
3539806,POÁ,SP,SUDESTE,71072,36451,34621
3539905,POLONI,SP,SUDESTE,3384,2149,1235
3540002,POMPÉIA,SP,SUDESTE,12662,9001,3661
3540101,PONGAÍ,SP,SUDESTE,2330,1575,755
3540200,PONTAL,SP,SUDESTE,22322,11760,10562
3540259,PONTALINDA,SP,SUDESTE,2439,1192,1247
3540309,PONTES GESTAL,SP,SUDESTE,1750,1002,748
3540408,POPULINA,SP,SUDESTE,2812,1218,1594
3540507,PORANGABA,SP,SUDESTE,5368,3152,2216
3540606,PORTO FELIZ,SP,SUDESTE,31293,21288,10005
3540705,PORTO FERREIRA,SP,SUDESTE,30687,20890,9797
3540754,POTIM,SP,SUDESTE,10004,5933,4071
3540804,POTIRENDABA,SP,SUDESTE,10597,6900,3697
3540853,PRACINHA,SP,SUDESTE,1061,585,476
3540903,PRADÓPOLIS,SP,SUDESTE,10393,6033,4360
3541000,PRAIA GRANDE,SP,SUDESTE,180208,105028,75180
3541059,PRATÂNIA,SP,SUDESTE,3454,1930,1524
3541109,PRESIDENTE ALVES,SP,SUDESTE,2553,1513,1040
3541208,PRESIDENTE BERNARDES,SP,SUDESTE,8143,4928,3215
3541307,PRESIDENTE EPITÁCIO,SP,SUDESTE,21922,12892,9030
3541406,PRESIDENTE PRUDENTE,SP,SUDESTE,131674,89544,42130
3541505,PRESIDENTE VENCESLAU,SP,SUDESTE,20673,14070,6603
3541604,PROMISSÃO,SP,SUDESTE,19959,11929,8030
3541653,QUADRA,SP,SUDESTE,2735,1617,1118
3541703,QUATÁ,SP,SUDESTE,7725,4855,2870
3541802,QUEIROZ,SP,SUDESTE,2329,1292,1037
3541901,QUELUZ,SP,SUDESTE,5436,2528,2908
3542008,QUINTANA,SP,SUDESTE,4119,2501,1618
3542107,RAFARD,SP,SUDESTE,5745,3980,1765
3542206,RANCHARIA,SP,SUDESTE,17441,10043,7398
3542305,REDENÇÃO DA SERRA,SP,SUDESTE,3057,1643,1414
3542404,REGENTE FEIJÓ,SP,SUDESTE,12103,7588,4515
3542503,REGINÓPOLIS,SP,SUDESTE,3634,2516,1118
3542602,REGISTRO,SP,SUDESTE,33472,20895,12577
3542701,RESTINGA,SP,SUDESTE,5039,2565,2474
3542800,RIBEIRA,SP,SUDESTE,2252,923,1329
3542909,RIBEIRÃO BONITO,SP,SUDESTE,6303,3438,2865
3543006,RIBEIRÃO BRANCO,SP,SUDESTE,10870,5287,5583
3543105,RIBEIRÃO CORRENTE,SP,SUDESTE,3259,1770,1489
3543204,RIBEIRÃO DO SUL,SP,SUDESTE,3105,1596,1509
3543238,RIBEIRÃO DOS ÍNDIOS,SP,SUDESTE,1465,700,765
3543253,RIBEIRÃO GRANDE,SP,SUDESTE,4950,2197,2753
3543303,RIBEIRÃO PIRES,SP,SUDESTE,67518,34652,32866
3543402,RIBEIRÃO PRETO,SP,SUDESTE,346147,206363,139784
3543501,RIVERSUL,SP,SUDESTE,3403,1766,1637
3543600,RIFAINA,SP,SUDESTE,3349,1805,1544
3543709,RINCÃO,SP,SUDESTE,5508,2559,2949
3543808,RINÓPOLIS,SP,SUDESTE,5680,3881,1799
3543907,RIO CLARO,SP,SUDESTE,116390,78720,37670
3544004,RIO DAS PEDRAS,SP,SUDESTE,19382,12972,6410
3544103,RIO GRANDE DA SERRA,SP,SUDESTE,26283,11684,14599
3544202,RIOLÂNDIA,SP,SUDESTE,5405,2644,2761
3544251,ROSANA,SP,SUDESTE,10038,4526,5512
3544301,ROSEIRA,SP,SUDESTE,6616,4127,2489
3544400,RUBIÁCEA,SP,SUDESTE,1771,1058,713
3544509,RUBINÉIA,SP,SUDESTE,2347,1435,912
3544608,SABINO,SP,SUDESTE,3222,1882,1340
3544707,SAGRES,SP,SUDESTE,1552,808,744
3544806,SALES,SP,SUDESTE,3839,2770,1069
3544905,SALES OLIVEIRA,SP,SUDESTE,6429,4105,2324
3545001,SALESÓPOLIS,SP,SUDESTE,11340,6834,4506
3545100,SALMOURÃO,SP,SUDESTE,2994,1746,1248
3545159,SALTINHO,SP,SUDESTE,5578,4530,1048
3545209,SALTO,SP,SUDESTE,73071,44746,28325
3545308,SALTO DE PIRAPORA,SP,SUDESTE,22949,13494,9455
3545407,SALTO GRANDE,SP,SUDESTE,4906,2861,2045
3545506,SANDOVALINA,SP,SUDESTE,2558,948,1610
3545605,SANTA ADÉLIA,SP,SUDESTE,8349,5173,3176
3545704,SANTA ALBERTINA,SP,SUDESTE,3925,2402,1523
3545803,SANTA BÁRBARA D'OESTE,SP,SUDESTE,110889,73567,37322
3546009,SANTA BRANCA,SP,SUDESTE,8816,5331,3485
3546108,SANTA CLARA D'OESTE,SP,SUDESTE,1762,1008,754
3546207,SANTA CRUZ DA CONCEIÇÃO,SP,SUDESTE,3085,2164,921
3546256,SANTA CRUZ DA ESPERANÇA,SP,SUDESTE,1567,906,661
3546306,SANTA CRUZ DAS PALMEIRAS,SP,SUDESTE,16125,10023,6102
3546405,SANTA CRUZ DO RIO PARDO,SP,SUDESTE,25813,18666,7147
3546504,SANTA ERNESTINA,SP,SUDESTE,3935,2100,1835
3546603,SANTA FÉ DO SUL,SP,SUDESTE,19409,13258,6151
3546702,SANTA GERTRUDES,SP,SUDESTE,14646,9747,4899
3546801,SANTA ISABEL,SP,SUDESTE,31656,19461,12195
3546900,SANTA LÚCIA,SP,SUDESTE,4975,2103,2872
3547007,SANTA MARIA DA SERRA,SP,SUDESTE,3209,2045,1164
3547106,SANTA MERCEDES,SP,SUDESTE,1875,975,900
3547205,SANTANA DA PONTE PENSA,SP,SUDESTE,1198,707,491
3547304,SANTANA DE PARNAÍBA,SP,SUDESTE,77577,42530,35047
3547403,SANTA RITA D'OESTE,SP,SUDESTE,1864,1062,802
3547502,SANTA RITA DO PASSA QUATRO,SP,SUDESTE,14922,10369,4553
3547601,SANTA ROSA DE VITERBO,SP,SUDESTE,13759,7780,5979
3547650,SANTA SALETE,SP,SUDESTE,1356,929,427
3547700,SANTO ANASTÁCIO,SP,SUDESTE,11612,6950,4662
3547809,SANTO ANDRÉ,SP,SUDESTE,433097,225767,207330
3547908,SANTO ANTÔNIO DA ALEGRIA,SP,SUDESTE,4215,2319,1896
3548005,SANTO ANTÔNIO DE POSSE,SP,SUDESTE,12843,8598,4245
3548054,SANTO ANTÔNIO DO ARACANGUÁ,SP,SUDESTE,5553,3292,2261
3548104,SANTO ANTÔNIO DO JARDIM,SP,SUDESTE,4007,2563,1444
3548203,SANTO ANTÔNIO DO PINHAL,SP,SUDESTE,4742,2714,2028
3548302,SANTO EXPEDITO,SP,SUDESTE,2088,1091,997
3548401,SANTÓPOLIS DO AGUAPEÍ,SP,SUDESTE,2461,1486,975
3548500,SANTOS,SP,SUDESTE,259567,145874,113693
3548609,SÃO BENTO DO SAPUCAÍ,SP,SUDESTE,6981,4425,2556
3548708,SÃO BERNARDO DO CAMPO,SP,SUDESTE,487152,224929,262223
3548807,SÃO CAETANO DO SUL,SP,SUDESTE,113449,68152,45297
3548906,SÃO CARLOS,SP,SUDESTE,141689,73647,68042
3549003,SÃO FRANCISCO,SP,SUDESTE,1870,1039,831
3549102,SÃO JOÃO DA BOA VISTA,SP,SUDESTE,52462,34240,18222
3549201,SÃO JOÃO DAS DUAS PONTES,SP,SUDESTE,1738,757,981
3549250,SÃO JOÃO DE IRACEMA,SP,SUDESTE,1334,580,754
3549300,SÃO JOÃO DO PAU D'ALHO,SP,SUDESTE,1589,736,853
3549409,SÃO JOAQUIM DA BARRA,SP,SUDESTE,27843,14884,12959
3549508,SÃO JOSÉ DA BELA VISTA,SP,SUDESTE,4911,2306,2605
3549607,SÃO JOSÉ DO BARREIRO,SP,SUDESTE,2851,1208,1643
3549706,SÃO JOSÉ DO RIO PARDO,SP,SUDESTE,30119,19222,10897
3549805,SÃO JOSÉ DO RIO PRETO,SP,SUDESTE,259690,176282,83408
3549904,SÃO JOSÉ DOS CAMPOS,SP,SUDESTE,427611,267615,159996
3549953,SÃO LOURENÇO DA SERRA,SP,SUDESTE,8795,4547,4248
3550001,SÃO LUÍS DO PARAITINGA,SP,SUDESTE,7560,3936,3624
3550100,SÃO MANUEL,SP,SUDESTE,22589,13999,8590
3550209,SÃO MIGUEL ARCANJO,SP,SUDESTE,18711,11433,7278
3550308,SÃO PAULO,SP,SUDESTE,6869405,3191484,3677921
3550407,SÃO PEDRO,SP,SUDESTE,19838,14197,5641
3550506,SÃO PEDRO DO TURVO,SP,SUDESTE,4375,2540,1835
3550605,SÃO ROQUE,SP,SUDESTE,45278,25488,19790
3550704,SÃO SEBASTIÃO,SP,SUDESTE,48657,24723,23934
3550803,SÃO SEBASTIÃO DA GRAMA,SP,SUDESTE,6343,3811,2532
3550902,SÃO SIMÃO,SP,SUDESTE,8541,5089,3452
3551009,SÃO VICENTE,SP,SUDESTE,188857,102155,86702
3551108,SARAPUÍ,SP,SUDESTE,5626,3120,2506
3551207,SARUTAIÁ,SP,SUDESTE,2336,1030,1306
3551306,SEBASTIANÓPOLIS DO SUL,SP,SUDESTE,2304,1515,789
3551405,SERRA AZUL,SP,SUDESTE,5737,2710,3027
3551504,SERRANA,SP,SUDESTE,25899,14158,11741
3551603,SERRA NEGRA,SP,SUDESTE,16729,11251,5478
3551702,SERTÃOZINHO,SP,SUDESTE,71637,40647,30990
3551801,SETE BARRAS,SP,SUDESTE,7425,4441,2984
3551900,SEVERÍNIA,SP,SUDESTE,9301,5451,3850
3552007,SILVEIRAS,SP,SUDESTE,4054,2168,1886
3552106,SOCORRO,SP,SUDESTE,23271,17292,5979
3552205,SOROCABA,SP,SUDESTE,396409,242074,154335
3552304,SUD MENNUCCI,SP,SUDESTE,4687,2325,2362
3552403,SUMARÉ,SP,SUDESTE,149675,85776,63899
3552502,SUZANO,SP,SUDESTE,170843,90882,79961
3552551,SUZANÁPOLIS,SP,SUDESTE,2170,986,1184
3552601,TABAPUÃ,SP,SUDESTE,7013,4729,2284
3552700,TABATINGA,SP,SUDESTE,8511,4902,3609
3552809,TABOÃO DA SERRA,SP,SUDESTE,169492,70456,99036
3552908,TACIBA,SP,SUDESTE,4113,2009,2104
3553005,TAGUAÍ,SP,SUDESTE,7048,4152,2896
3553104,TAIAÇU,SP,SUDESTE,3518,1858,1660
3553203,TAIÚVA,SP,SUDESTE,3449,2295,1154
3553302,TAMBAÚ,SP,SUDESTE,12061,6894,5167
3553401,TANABI,SP,SUDESTE,15515,10261,5254
3553500,TAPIRAÍ,SP,SUDESTE,4437,2645,1792
3553609,TAPIRATIBA,SP,SUDESTE,7569,3902,3667
3553658,TAQUARAL,SP,SUDESTE,1772,1042,730
3553708,TAQUARITINGA,SP,SUDESTE,28990,17518,11472
3553807,TAQUARITUBA,SP,SUDESTE,13312,7291,6021
3553856,TAQUARIVAÍ,SP,SUDESTE,3733,2025,1708
3553906,TARABAI,SP,SUDESTE,4125,1902,2223
3553955,TARUMÃ,SP,SUDESTE,9038,5515,3523
3554003,TATUÍ,SP,SUDESTE,65092,43669,21423
3554102,TAUBATÉ,SP,SUDESTE,177494,117578,59916
3554201,TEJUPÁ,SP,SUDESTE,2720,1233,1487
3554300,TEODORO SAMPAIO,SP,SUDESTE,12955,6018,6937
3554409,TERRA ROXA,SP,SUDESTE,4843,2837,2006
3554508,TIETÊ,SP,SUDESTE,22495,15760,6735
3554607,TIMBURI,SP,SUDESTE,1717,921,796
3554656,TORRE DE PEDRA,SP,SUDESTE,1836,1247,589
3554706,TORRINHA,SP,SUDESTE,5425,3877,1548
3554755,TRABIJU,SP,SUDESTE,1202,543,659
3554805,TREMEMBÉ,SP,SUDESTE,22535,14617,7918
3554904,TRÊS FRONTEIRAS,SP,SUDESTE,3697,2220,1477
3554953,TUIUTI,SP,SUDESTE,4052,2702,1350
3555000,TUPÃ,SP,SUDESTE,36312,25604,10708
3555109,TUPI PAULISTA,SP,SUDESTE,8480,5567,2913
3555208,TURIÚBA,SP,SUDESTE,1278,841,437
3555307,TURMALINA,SP,SUDESTE,1360,625,735
3555356,UBARANA,SP,SUDESTE,3417,1864,1553
3555406,UBATUBA,SP,SUDESTE,53730,33967,19763
3555505,UBIRAJARA,SP,SUDESTE,3109,1769,1340
3555604,UCHOA,SP,SUDESTE,6114,3750,2364
3555703,UNIÃO PAULISTA,SP,SUDESTE,1182,679,503
3555802,URÂNIA,SP,SUDESTE,5264,3321,1943
3555901,URU,SP,SUDESTE,1125,737,388
3556008,URUPÊS,SP,SUDESTE,8208,5795,2413
3556107,VALENTIM GENTIL,SP,SUDESTE,7782,4955,2827
3556206,VALINHOS,SP,SUDESTE,72293,46594,25699
3556305,VALPARAÍSO,SP,SUDESTE,12248,7410,4838
3556354,VARGEM,SP,SUDESTE,4732,3039,1693
3556404,VARGEM GRANDE DO SUL,SP,SUDESTE,23167,15236,7931
3556453,VARGEM GRANDE PAULISTA,SP,SUDESTE,30862,16659,14203
3556503,VÁRZEA PAULISTA,SP,SUDESTE,63876,37506,26370
3556602,VERA CRUZ,SP,SUDESTE,6077,3779,2298
3556701,VINHEDO,SP,SUDESTE,48663,32648,16015
3556800,VIRADOURO,SP,SUDESTE,10416,6828,3588
3556909,VISTA ALEGRE DO ALTO,SP,SUDESTE,4656,2777,1879
3556958,VITÓRIA BRASIL,SP,SUDESTE,1313,746,567
3557006,VOTORANTIM,SP,SUDESTE,69266,42096,27170
3557105,VOTUPORANGA,SP,SUDESTE,53561,36549,17012
3557154,ZACARIAS,SP,SUDESTE,1836,1116,720
3557204,CHAVANTES,SP,SUDESTE,6960,4206,2754
3557303,ESTIVA GERBI,SP,SUDESTE,7202,4750,2452
4100103,ABATIÁ,PR,SUL,4546,2605,1941
4100202,ADRIANÓPOLIS,PR,SUL,4005,1537,2468
4100301,AGUDOS DO SUL,PR,SUL,6394,4051,2343
4100400,ALMIRANTE TAMANDARÉ,PR,SUL,58038,33534,24504
4100459,ALTAMIRA DO PARANÁ,PR,SUL,2554,1147,1407
4100509,ALTÔNIA,PR,SUL,11445,7760,3685
4100608,ALTO PARANÁ,PR,SUL,8314,4583,3731
4100707,ALTO PIQUIRI,PR,SUL,5693,2762,2931
4100806,ALVORADA DO SUL,PR,SUL,5590,3387,2203
4100905,AMAPORÃ,PR,SUL,3175,1554,1621
4101002,AMPÉRE,PR,SUL,12095,5311,6784
4101051,ANAHY,PR,SUL,2198,1086,1112
4101101,ANDIRÁ,PR,SUL,12537,7396,5141
4101150,ÂNGULO,PR,SUL,2166,1437,729
4101200,ANTONINA,PR,SUL,11618,7596,4022
4101309,ANTÔNIO OLINTO,PR,SUL,5294,2769,2525
4101408,APUCARANA,PR,SUL,73508,51894,21614
4101507,ARAPONGAS,PR,SUL,66257,50404,15853
4101606,ARAPOTI,PR,SUL,14854,10014,4840
4101655,ARAPUÃ,PR,SUL,2566,1222,1344
4101705,ARARUNA,PR,SUL,8795,5252,3543
4101804,ARAUCÁRIA,PR,SUL,82982,45633,37349
4101853,ARIRANHA DO IVAÍ,PR,SUL,1855,787,1068
4101903,ASSAÍ,PR,SUL,9572,6742,2830
4102000,ASSIS CHATEAUBRIAND,PR,SUL,21750,14276,7474
4102109,ASTORGA,PR,SUL,16157,11738,4419
4102208,ATALAIA,PR,SUL,2911,1744,1167
4102307,BALSA NOVA,PR,SUL,9322,5834,3488
4102406,BANDEIRANTES,PR,SUL,19312,13737,5575
4102505,BARBOSA FERRAZ,PR,SUL,6580,3599,2981
4102604,BARRACÃO,PR,SUL,6019,3310,2709
4102703,BARRA DO JACARÉ,PR,SUL,2091,1085,1006
4102752,BELA VISTA DA CAROBA,PR,SUL,2451,1008,1443
4102802,BELA VISTA DO PARAÍSO,PR,SUL,9757,6097,3660
4102901,BITURUNA,PR,SUL,9672,4306,5366
4103008,BOA ESPERANÇA,PR,SUL,3115,2237,878
4103024,BOA ESPERANÇA DO IGUAÇU,PR,SUL,1922,721,1201
4103040,BOA VENTURA DE SÃO ROQUE,PR,SUL,4065,1594,2471
4103057,BOA VISTA DA APARECIDA,PR,SUL,5321,2718,2603
4103107,BOCAIÚVA DO SUL,PR,SUL,7431,4288,3143
4103156,BOM JESUS DO SUL,PR,SUL,2914,1361,1553
4103206,BOM SUCESSO,PR,SUL,4155,1906,2249
4103222,BOM SUCESSO DO SUL,PR,SUL,2459,1558,901
4103305,BORRAZÓPOLIS,PR,SUL,5136,3050,2086
4103354,BRAGANEY,PR,SUL,3579,1953,1626
4103370,BRASILÂNDIA DO SUL,PR,SUL,2480,1134,1346
4103404,CAFEARA,PR,SUL,1819,797,1022
4103453,CAFELÂNDIA,PR,SUL,10653,7165,3488
4103479,CAFEZAL DO SUL,PR,SUL,3208,1986,1222
4103503,CALIFÓRNIA,PR,SUL,5582,3722,1860
4103602,CAMBARÁ,PR,SUL,13821,8539,5282
4103701,CAMBÉ,PR,SUL,58535,40519,18016
4103800,CAMBIRA,PR,SUL,5047,3248,1799
4103909,CAMPINA DA LAGOA,PR,SUL,9328,5426,3902
4103958,CAMPINA DO SIMÃO,PR,SUL,2765,1006,1759
4104006,CAMPINA GRANDE DO SUL,PR,SUL,26496,16566,9930
4104055,CAMPO BONITO,PR,SUL,2896,1372,1524
4104105,CAMPO DO TENENTE,PR,SUL,4952,3105,1847
4104204,CAMPO LARGO,PR,SUL,72563,47247,25316
4104253,CAMPO MAGRO,PR,SUL,16062,9351,6711
4104303,CAMPO MOURÃO,PR,SUL,54884,33849,21035
4104402,CÂNDIDO DE ABREU,PR,SUL,8874,4816,4058
4104428,CANDÓI,PR,SUL,9169,4118,5051
4104451,CANTAGALO,PR,SUL,6886,2937,3949
4104501,CAPANEMA,PR,SUL,12353,6462,5891
4104600,CAPITÃO LEÔNIDAS MARQUES,PR,SUL,9311,5076,4235
4104659,CARAMBEÍ,PR,SUL,13398,9655,3743
4104709,CARLÓPOLIS,PR,SUL,9044,5529,3515
4104808,CASCAVEL,PR,SUL,187441,125392,62049
4104907,CASTRO,PR,SUL,43328,27913,15415
4105003,CATANDUVAS,PR,SUL,5446,3114,2332
4105102,CENTENÁRIO DO SUL,PR,SUL,6694,2846,3848
4105201,CERRO AZUL,PR,SUL,10262,4473,5789
4105300,CÉU AZUL,PR,SUL,7178,5408,1770
4105409,CHOPINZINHO,PR,SUL,13368,7723,5645
4105508,CIANORTE,PR,SUL,45364,32866,12498
4105607,CIDADE GAÚCHA,PR,SUL,6927,3855,3072
4105706,CLEVELÂNDIA,PR,SUL,10085,5138,4947
4105805,COLOMBO,PR,SUL,123372,75459,47913
4105904,COLORADO,PR,SUL,14554,7829,6725
4106001,CONGONHINHAS,PR,SUL,5020,2062,2958
4106100,CONSELHEIRO MAIRINCK,PR,SUL,2326,1196,1130
4106209,CONTENDA,PR,SUL,10484,6047,4437
4106308,CORBÉLIA,PR,SUL,11329,7546,3783
4106407,CORNÉLIO PROCÓPIO,PR,SUL,27941,17918,10023
4106456,CORONEL DOMINGOS SOARES,PR,SUL,3905,1528,2377
4106506,CORONEL VIVIDA,PR,SUL,14157,7429,6728
4106555,CORUMBATAÍ DO SUL,PR,SUL,2735,1306,1429
4106571,CRUZEIRO DO IGUAÇU,PR,SUL,2866,1323,1543
4106605,CRUZEIRO DO OESTE,PR,SUL,13018,8195,4823
4106704,CRUZEIRO DO SUL,PR,SUL,3187,1842,1345
4106803,CRUZ MACHADO,PR,SUL,10817,6324,4493
4106852,CRUZMALTINA,PR,SUL,2115,1248,867
4106902,CURITIBA,PR,SUL,1111997,720322,391675
4107009,CURIÚVA,PR,SUL,8018,4358,3660
4107108,DIAMANTE DO NORTE,PR,SUL,3425,1973,1452
4107124,DIAMANTE DO SUL,PR,SUL,2359,1178,1181
4107157,DIAMANTE D'OESTE,PR,SUL,2955,1205,1750
4107207,DOIS VIZINHOS,PR,SUL,26441,13835,12606
4107256,DOURADINA,PR,SUL,5414,3536,1878
4107306,DOUTOR CAMARGO,PR,SUL,4076,2699,1377
4107405,ENÉAS MARQUES,PR,SUL,4404,1917,2487
4107504,ENGENHEIRO BELTRÃO,PR,SUL,8221,5024,3197
4107520,ESPERANÇA NOVA,PR,SUL,1587,1078,509
4107538,ENTRE RIOS DO OESTE,PR,SUL,3008,2240,768
4107546,ESPIGÃO ALTO DO IGUAÇU,PR,SUL,3241,1947,1294
4107553,FAROL,PR,SUL,2230,1150,1080
4107603,FAXINAL,PR,SUL,9503,6715,2788
4107652,FAZENDA RIO GRANDE,PR,SUL,63624,38273,25351
4107702,FÊNIX,PR,SUL,3037,1500,1537
4107736,FERNANDES PINHEIRO,PR,SUL,4387,2315,2072
4107751,FIGUEIRA,PR,SUL,4903,2069,2834
4107801,FLORAÍ,PR,SUL,3687,2171,1516
4107850,FLOR DA SERRA DO SUL,PR,SUL,3647,1713,1934
4107900,FLORESTA,PR,SUL,5590,3531,2059
4108007,FLORESTÓPOLIS,PR,SUL,7627,3636,3991
4108106,FLÓRIDA,PR,SUL,1924,990,934
4108205,FORMOSA DO OESTE,PR,SUL,4873,3162,1711
4108304,FOZ DO IGUAÇU,PR,SUL,157494,104235,53259
4108320,FRANCISCO ALVES,PR,SUL,4653,2941,1712
4108403,FRANCISCO BELTRÃO,PR,SUL,54451,29417,25034
4108452,FOZ DO JORDÃO,PR,SUL,3229,1170,2059
4108502,GENERAL CARNEIRO,PR,SUL,6553,3101,3452
4108551,GODOY MOREIRA,PR,SUL,2070,819,1251
4108601,GOIOERÊ,PR,SUL,17123,11033,6090
4108650,GOIOXIM,PR,SUL,4110,1475,2635
4108700,GRANDES RIOS,PR,SUL,3726,2398,1328
4108809,GUAÍRA,PR,SUL,18123,12496,5627
4108908,GUAIRAÇÁ,PR,SUL,4054,2381,1673
4108957,GUAMIRANGA,PR,SUL,5450,3301,2149
4109005,GUAPIRAMA,PR,SUL,2942,1572,1370
4109104,GUAPOREMA,PR,SUL,1567,882,685
4109203,GUARACI,PR,SUL,3438,2139,1299
4109302,GUARANIAÇU,PR,SUL,8657,5423,3234
4109401,GUARAPUAVA,PR,SUL,105475,57176,48299
4109500,GUARAQUEÇABA,PR,SUL,5036,2765,2271
4109609,GUARATUBA,PR,SUL,21598,14752,6846
4109658,HONÓRIO SERPA,PR,SUL,3470,1436,2034
4109708,IBAITI,PR,SUL,16278,9844,6434
4109757,IBEMA,PR,SUL,3883,1951,1932
4109807,IBIPORÃ,PR,SUL,30695,21060,9635
4109906,ICARAÍMA,PR,SUL,5515,3557,1958
4110003,IGUARAÇU,PR,SUL,3092,1917,1175
4110052,IGUATU,PR,SUL,1638,775,863
4110078,IMBAÚ,PR,SUL,6690,3251,3439
4110102,IMBITUVA,PR,SUL,18679,11825,6854
4110201,INÁCIO MARTINS,PR,SUL,6427,2934,3493
4110300,INAJÁ,PR,SUL,1848,738,1110
4110409,INDIANÓPOLIS,PR,SUL,3009,1878,1131
4110508,IPIRANGA,PR,SUL,9286,6130,3156
4110607,IPORÃ,PR,SUL,9159,5945,3214
4110656,IRACEMA DO OESTE,PR,SUL,1868,952,916
4110706,IRATI,PR,SUL,36753,22388,14365
4110805,IRETAMA,PR,SUL,5968,2737,3231
4110904,ITAGUAJÉ,PR,SUL,2712,1268,1444
4110953,ITAIPULÂNDIA,PR,SUL,7605,4723,2882
4111001,ITAMBARACÁ,PR,SUL,3866,2374,1492
4111100,ITAMBÉ,PR,SUL,4092,2434,1658
4111209,ITAPEJARA D'OESTE,PR,SUL,7449,3633,3816
4111258,ITAPERUÇU,PR,SUL,17041,6729,10312
4111308,ITAÚNA DO SUL,PR,SUL,2147,800,1347
4111407,IVAÍ,PR,SUL,8621,5218,3403
4111506,IVAIPORÃ,PR,SUL,19315,11012,8303
4111555,IVATÉ,PR,SUL,4465,2427,2038
4111605,IVATUBA,PR,SUL,2029,1266,763
4111704,JABOTI,PR,SUL,3448,2034,1414
4111803,JACAREZINHO,PR,SUL,23369,12130,11239
4111902,JAGUAPITÃ,PR,SUL,8164,5127,3037
4112009,JAGUARIAÍVA,PR,SUL,20389,13193,7196
4112108,JANDAIA DO SUL,PR,SUL,13261,9247,4014
4112207,JANIÓPOLIS,PR,SUL,3772,1912,1860
4112306,JAPIRA,PR,SUL,2941,1491,1450
4112405,JAPURÁ,PR,SUL,5817,4057,1760
4112504,JARDIM ALEGRE,PR,SUL,7318,3933,3385
4112603,JARDIM OLINDA,PR,SUL,1026,337,689
4112702,JATAIZINHO,PR,SUL,7466,4645,2821
4112751,JESUÍTAS,PR,SUL,5920,3683,2237
4112801,JOAQUIM TÁVORA,PR,SUL,7227,4438,2789
4112900,JUNDIAÍ DO SUL,PR,SUL,2040,856,1184
4112959,JURANDA,PR,SUL,4962,3083,1879
4113007,JUSSARA,PR,SUL,4381,2615,1766
4113106,KALORÉ,PR,SUL,3151,1831,1320
4113205,LAPA,PR,SUL,29226,17280,11946
4113254,LARANJAL,PR,SUL,3513,1187,2326
4113304,LARANJEIRAS DO SUL,PR,SUL,19067,8702,10365
4113403,LEÓPOLIS,PR,SUL,2722,1365,1357
4113429,LIDIANÓPOLIS,PR,SUL,2679,1639,1040
4113452,LINDOESTE,PR,SUL,3937,1718,2219
4113502,LOANDA,PR,SUL,12289,8021,4268
4113601,LOBATO,PR,SUL,3093,1597,1496
4113700,LONDRINA,PR,SUL,309272,225349,83923
4113734,LUIZIANA,PR,SUL,4459,2196,2263
4113759,LUNARDELLI,PR,SUL,3220,1789,1431
4113809,LUPIONÓPOLIS,PR,SUL,3123,1424,1699
4113908,MALLET,PR,SUL,8572,5432,3140
4114005,MAMBORÊ,PR,SUL,8708,5938,2770
4114104,MANDAGUAÇU,PR,SUL,14748,9151,5597
4114203,MANDAGUARI,PR,SUL,22102,14604,7498
4114302,MANDIRITUBA,PR,SUL,14980,8792,6188
4114351,MANFRINÓPOLIS,PR,SUL,2347,778,1569
4114401,MANGUEIRINHA,PR,SUL,10734,5130,5604
4114500,MANOEL RIBAS,PR,SUL,8700,5675,3025
4114609,MARECHAL CÂNDIDO RONDON,PR,SUL,32344,24373,7971
4114708,MARIA HELENA,PR,SUL,3827,2066,1761
4114807,MARIALVA,PR,SUL,23147,15799,7348
4114906,MARILÂNDIA DO SUL,PR,SUL,5607,3648,1959
4115002,MARILENA,PR,SUL,4537,1961,2576
4115101,MARILUZ,PR,SUL,6210,3122,3088
4115200,MARINGÁ,PR,SUL,231936,157051,74885
4115309,MARIÓPOLIS,PR,SUL,4337,2579,1758
4115358,MARIPÁ,PR,SUL,4271,3474,797
4115408,MARMELEIRO,PR,SUL,9340,4667,4673
4115457,MARQUINHO,PR,SUL,2989,1273,1716
4115507,MARUMBI,PR,SUL,3124,1599,1525
4115606,MATELÂNDIA,PR,SUL,10692,8285,2407
4115705,MATINHOS,PR,SUL,22655,13297,9358
4115739,MATO RICO,PR,SUL,2568,963,1605
4115754,MAUÁ DA SERRA,PR,SUL,5665,3373,2292
4115804,MEDIANEIRA,PR,SUL,29910,20583,9327
4115853,MERCEDES,PR,SUL,4052,3338,714
4115903,MIRADOR,PR,SUL,1607,596,1011
4116000,MIRASELVA,PR,SUL,1477,809,668
4116059,MISSAL,PR,SUL,7616,5138,2478
4116109,MOREIRA SALES,PR,SUL,7499,4475,3024
4116208,MORRETES,PR,SUL,10632,6339,4293
4116307,MUNHOZ DE MELO,PR,SUL,2730,1554,1176
4116406,NOSSA SENHORA DAS GRAÇAS,PR,SUL,2489,1056,1433
4116505,NOVA ALIANÇA DO IVAÍ,PR,SUL,1179,610,569
4116604,NOVA AMÉRICA DA COLINA,PR,SUL,2529,1375,1154
4116703,NOVA AURORA,PR,SUL,8165,5304,2861
4116802,NOVA CANTU,PR,SUL,4616,1977,2639
4116901,NOVA ESPERANÇA,PR,SUL,15798,10139,5659
4116950,NOVA ESPERANÇA DO SUDOESTE,PR,SUL,3914,1635,2279
4117008,NOVA FÁTIMA,PR,SUL,4650,2592,2058
4117057,NOVA LARANJEIRAS,PR,SUL,6426,2685,3741
4117107,NOVA LONDRINA,PR,SUL,7483,4211,3272
4117206,NOVA OLÍMPIA,PR,SUL,3892,2470,1422
4117214,NOVA SANTA BÁRBARA,PR,SUL,2715,1264,1451
4117222,NOVA SANTA ROSA,PR,SUL,5905,5062,843
4117255,NOVA PRATA DO IGUAÇU,PR,SUL,7017,3211,3806
4117271,NOVA TEBAS,PR,SUL,4524,1611,2913
4117297,NOVO ITACOLOMI,PR,SUL,2313,1439,874
4117305,ORTIGUEIRA,PR,SUL,14130,6128,8002
4117404,OURIZONA,PR,SUL,2266,1059,1207
4117453,OURO VERDE DO OESTE,PR,SUL,3959,2490,1469
4117503,PAIÇANDU,PR,SUL,22469,12968,9501
4117602,PALMAS,PR,SUL,23776,11024,12752
4117701,PALMEIRA,PR,SUL,21771,14919,6852
4117800,PALMITAL,PR,SUL,8368,3808,4560
4117909,PALOTINA,PR,SUL,19997,14852,5145
4118006,PARAÍSO DO NORTE,PR,SUL,7871,4262,3609
4118105,PARANACITY,PR,SUL,5930,2799,3131
4118204,PARANAGUÁ,PR,SUL,83002,54905,28097
4118303,PARANAPOEMA,PR,SUL,1701,692,1009
4118402,PARANAVAÍ,PR,SUL,50124,33961,16163
4118451,PATO BRAGADO,PR,SUL,3680,2855,825
4118501,PATO BRANCO,PR,SUL,50977,31260,19717
4118600,PAULA FREITAS,PR,SUL,3669,2263,1406
4118709,PAULO FRONTIN,PR,SUL,4588,2700,1888
4118808,PEABIRU,PR,SUL,8009,4582,3427
4118857,PEROBAL,PR,SUL,4272,2811,1461
4118907,PÉROLA,PR,SUL,7221,4454,2767
4119004,PÉROLA D'OESTE,PR,SUL,4390,2569,1821
4119103,PIÊN,PR,SUL,8567,6253,2314
4119152,PINHAIS,PR,SUL,74614,46689,27925
4119202,PINHALÃO,PR,SUL,4378,2480,1898
4119251,PINHAL DE SÃO BENTO,PR,SUL,1920,542,1378
4119301,PINHÃO,PR,SUL,17767,7026,10741
4119400,PIRAÍ DO SUL,PR,SUL,14715,9166,5549
4119509,PIRAQUARA,PR,SUL,53451,30480,22971
4119608,PITANGA,PR,SUL,20412,9980,10432
4119657,PITANGUEIRAS,PR,SUL,2062,1312,750
4119707,PLANALTINA DO PARANÁ,PR,SUL,2643,1249,1394
4119806,PLANALTO,PR,SUL,8423,4107,4316
4119905,PONTA GROSSA,PR,SUL,200456,130481,69975
4119954,PONTAL DO PARANÁ,PR,SUL,15614,9148,6466
4120002,PORECATU,PR,SUL,7546,3896,3650
4120101,PORTO AMAZONAS,PR,SUL,2949,1868,1081
4120150,PORTO BARREIRO,PR,SUL,2494,1188,1306
4120200,PORTO RICO,PR,SUL,2118,1322,796
4120309,PORTO VITÓRIA,PR,SUL,2508,1476,1032
4120333,PRADO FERREIRA,PR,SUL,2548,1324,1224
4120358,PRANCHITA,PR,SUL,3866,2314,1552
4120408,PRESIDENTE CASTELO BRANCO,PR,SUL,3092,1438,1654
4120507,PRIMEIRO DE MAIO,PR,SUL,6980,4600,2380
4120606,PRUDENTÓPOLIS,PR,SUL,31213,22904,8309
4120655,QUARTO CENTENÁRIO,PR,SUL,2882,1602,1280
4120705,QUATIGUÁ,PR,SUL,5334,3492,1842
4120804,QUATRO BARRAS,PR,SUL,13495,9272,4223
4120853,QUATRO PONTES,PR,SUL,3274,2790,484
4120903,QUEDAS DO IGUAÇU,PR,SUL,18068,10962,7106
4121000,QUERÊNCIA DO NORTE,PR,SUL,6446,3018,3428
4121109,QUINTA DO SOL,PR,SUL,3360,1677,1683
4121208,QUITANDINHA,PR,SUL,11248,7648,3600
4121257,RAMILÂNDIA,PR,SUL,2693,1260,1433
4121307,RANCHO ALEGRE,PR,SUL,2541,1544,997
4121356,RANCHO ALEGRE D'OESTE,PR,SUL,1894,1056,838
4121406,REALEZA,PR,SUL,11486,6634,4852
4121505,REBOUÇAS,PR,SUL,9728,5249,4479
4121604,RENASCENÇA,PR,SUL,4320,2142,2178
4121703,RESERVA,PR,SUL,15474,8576,6898
4121752,RESERVA DO IGUAÇU,PR,SUL,4058,1543,2515
4121802,RIBEIRÃO CLARO,PR,SUL,7405,4118,3287
4121901,RIBEIRÃO DO PINHAL,PR,SUL,7733,3336,4397
4122008,RIO AZUL,PR,SUL,9214,6104,3110
4122107,RIO BOM,PR,SUL,2336,1341,995
4122156,RIO BONITO DO IGUAÇU,PR,SUL,8568,2699,5869
4122172,RIO BRANCO DO IVAÍ,PR,SUL,2533,1342,1191
4122206,RIO BRANCO DO SUL,PR,SUL,21584,10509,11075
4122305,RIO NEGRO,PR,SUL,19119,14050,5069
4122404,ROLÂNDIA,PR,SUL,38355,27558,10797
4122503,RONCADOR,PR,SUL,6843,3171,3672
4122602,RONDON,PR,SUL,5790,3601,2189
4122651,ROSÁRIO DO IVAÍ,PR,SUL,3459,1988,1471
4122701,SABÁUDIA,PR,SUL,5037,3681,1356
4122800,SALGADO FILHO,PR,SUL,2948,1496,1452
4122909,SALTO DO ITARARÉ,PR,SUL,3322,1574,1748
4123006,SALTO DO LONTRA,PR,SUL,9020,3463,5557
4123105,SANTA AMÉLIA,PR,SUL,2337,1262,1075
4123204,SANTA CECÍLIA DO PAVÃO,PR,SUL,2357,1248,1109
4123303,SANTA CRUZ DE MONTE CASTELO,PR,SUL,5280,2982,2298
4123402,SANTA FÉ,PR,SUL,7157,4337,2820
4123501,SANTA HELENA,PR,SUL,16792,10309,6483
4123600,SANTA INÊS,PR,SUL,1392,618,774
4123709,SANTA ISABEL DO IVAÍ,PR,SUL,5440,3540,1900
4123808,SANTA IZABEL DO OESTE,PR,SUL,7422,3898,3524
4123824,SANTA LÚCIA,PR,SUL,2577,1429,1148
4123857,SANTA MARIA DO OESTE,PR,SUL,6358,2573,3785
4123907,SANTA MARIANA,PR,SUL,7153,3691,3462
4123956,SANTA MÔNICA,PR,SUL,2158,971,1187
4124004,SANTANA DO ITARARÉ,PR,SUL,3536,1678,1858
4124020,SANTA TEREZA DO OESTE,PR,SUL,7438,4469,2969
4124053,SANTA TEREZINHA DE ITAIPU,PR,SUL,14580,10322,4258
4124103,SANTO ANTÔNIO DA PLATINA,PR,SUL,25309,16140,9169
4124202,SANTO ANTÔNIO DO CAIUÁ,PR,SUL,1881,748,1133
4124301,SANTO ANTÔNIO DO PARAÍSO,PR,SUL,1708,846,862
4124400,SANTO ANTÔNIO DO SUDOESTE,PR,SUL,12108,6124,5984
4124509,SANTO INÁCIO,PR,SUL,3694,1832,1862
4124608,SÃO CARLOS DO IVAÍ,PR,SUL,4302,2633,1669
4124707,SÃO JERÔNIMO DA SERRA,PR,SUL,6139,2709,3430
4124806,SÃO JOÃO,PR,SUL,7412,4240,3172
4124905,SÃO JOÃO DO CAIUÁ,PR,SUL,3714,1493,2221
4125001,SÃO JOÃO DO IVAÍ,PR,SUL,6920,3514,3406
4125100,SÃO JOÃO DO TRIUNFO,PR,SUL,9308,3777,5531
4125209,SÃO JORGE D'OESTE,PR,SUL,6643,3688,2955
4125308,SÃO JORGE DO IVAÍ,PR,SUL,3817,2464,1353
4125357,SÃO JORGE DO PATROCÍNIO,PR,SUL,4116,2509,1607
4125407,SÃO JOSÉ DA BOA VISTA,PR,SUL,3622,2291,1331
4125456,SÃO JOSÉ DAS PALMEIRAS,PR,SUL,2660,1213,1447
4125506,SÃO JOSÉ DOS PINHAIS,PR,SUL,167698,111043,56655
4125555,SÃO MANOEL DO PARANÁ,PR,SUL,1602,995,607
4125605,SÃO MATEUS DO SUL,PR,SUL,27232,14627,12605
4125704,SÃO MIGUEL DO IGUAÇU,PR,SUL,17539,11195,6344
4125753,SÃO PEDRO DO IGUAÇU,PR,SUL,3982,2308,1674
4125803,SÃO PEDRO DO IVAÍ,PR,SUL,5447,3166,2281
4125902,SÃO PEDRO DO PARANÁ,PR,SUL,1980,1323,657
4126009,SÃO SEBASTIÃO DA AMOREIRA,PR,SUL,5228,2584,2644
4126108,SÃO TOMÉ,PR,SUL,3644,2317,1327
4126207,SAPOPEMA,PR,SUL,4090,1974,2116
4126256,SARANDI,PR,SUL,52223,29538,22685
4126272,SAUDADE DO IGUAÇU,PR,SUL,4161,1827,2334
4126306,SENGÉS,PR,SUL,10432,6368,4064
4126355,SERRANÓPOLIS DO IGUAÇU,PR,SUL,3591,2590,1001
4126405,SERTANEJA,PR,SUL,3907,2336,1571
4126504,SERTANÓPOLIS,PR,SUL,10537,7650,2887
4126603,SIQUEIRA CAMPOS,PR,SUL,12140,6351,5789
4126652,SULINA,PR,SUL,2336,1122,1214
4126678,TAMARANA,PR,SUL,6287,3773,2514
4126702,TAMBOARA,PR,SUL,3212,1928,1284
4126801,TAPEJARA,PR,SUL,9396,5738,3658
4126900,TAPIRA,PR,SUL,3672,2026,1646
4127007,TEIXEIRA SOARES,PR,SUL,6289,3720,2569
4127106,TELÊMACO BORBA,PR,SUL,40701,24430,16271
4127205,TERRA BOA,PR,SUL,10501,7072,3429
4127304,TERRA RICA,PR,SUL,9094,5807,3287
4127403,TERRA ROXA,PR,SUL,10876,7636,3240
4127502,TIBAGI,PR,SUL,11159,5660,5499
4127601,TIJUCAS DO SUL,PR,SUL,9602,5466,4136
4127700,TOLEDO,PR,SUL,84993,58445,26548
4127809,TOMAZINA,PR,SUL,5075,2837,2238
4127858,TRÊS BARRAS DO PARANÁ,PR,SUL,7289,4217,3072
4127882,TUNAS DO PARANÁ,PR,SUL,4051,2109,1942
4127908,TUNEIRAS DO OESTE,PR,SUL,5352,3328,2024
4127957,TUPÃSSI,PR,SUL,5075,3696,1379
4127965,TURVO,PR,SUL,9233,3815,5418
4128005,UBIRATÃ,PR,SUL,15141,9854,5287
4128104,UMUARAMA,PR,SUL,63870,45768,18102
4128203,UNIÃO DA VITÓRIA,PR,SUL,31149,19295,11854
4128302,UNIFLOR,PR,SUL,1761,832,929
4128401,URAÍ,PR,SUL,6839,4029,2810
4128500,WENCESLAU BRAZ,PR,SUL,11090,7098,3992
4128534,VENTANIA,PR,SUL,5921,2747,3174
4128559,VERA CRUZ DO OESTE,PR,SUL,5346,3308,2038
4128609,VERÊ,PR,SUL,5882,2721,3161
4128625,ALTO PARAÍSO,PR,SUL,2201,1293,908
4128633,DOUTOR ULYSSES,PR,SUL,3890,1669,2221
4128658,VIRMOND,PR,SUL,2822,1514,1308
4128708,VITORINO,PR,SUL,4538,2768,1770
4128807,XAMBRÊ,PR,SUL,4197,2494,1703
4200051,ABDON BATISTA,SC,SUL,2131,1357,774
4200101,ABELARDO LUZ,SC,SUL,9629,5685,3944
4200200,AGROLÂNDIA,SC,SUL,6785,5460,1325
4200309,AGRONÔMICA,SC,SUL,3731,3073,658
4200408,ÁGUA DOCE,SC,SUL,4428,3122,1306
4200507,ÁGUAS DE CHAPECÓ,SC,SUL,3887,1819,2068
4200556,ÁGUAS FRIAS,SC,SUL,2159,1234,925
4200606,ÁGUAS MORNAS,SC,SUL,5082,3693,1389
4200705,ALFREDO WAGNER,SC,SUL,6556,4733,1823
4200754,ALTO BELA VISTA,SC,SUL,1489,987,502
4200804,ANCHIETA,SC,SUL,4143,2282,1861
4200903,ANGELINA,SC,SUL,4228,2462,1766
4201000,ANITA GARIBALDI,SC,SUL,5615,2920,2695
4201109,ANITÁPOLIS,SC,SUL,2563,1653,910
4201208,ANTÔNIO CARLOS,SC,SUL,7172,5901,1271
4201257,APIÚNA,SC,SUL,6587,4886,1701
4201273,ARABUTÃ,SC,SUL,3152,2129,1023
4201307,ARAQUARI,SC,SUL,18329,12930,5399
4201406,ARARANGUÁ,SC,SUL,41153,28631,12522
4201505,ARMAZÉM,SC,SUL,5571,4165,1406
4201604,ARROIO TRINTA,SC,SUL,2627,1990,637
4201653,ARVOREDO,SC,SUL,2085,1233,852
4201703,ASCURRA,SC,SUL,5062,4176,886
4201802,ATALANTA,SC,SUL,2471,1978,493
4201901,AURORA,SC,SUL,4455,3581,874
4201950,BALNEÁRIO ARROIO DO SILVA,SC,SUL,8530,5300,3230
4202008,BALNEÁRIO CAMBORIÚ,SC,SUL,81846,61035,20811
4202057,BALNEÁRIO BARRA DO SUL,SC,SUL,8112,5809,2303
4202073,BALNEÁRIO GAIVOTA,SC,SUL,7953,5143,2810
4202081,BANDEIRANTE,SC,SUL,2371,1249,1122
4202099,BARRA BONITA,SC,SUL,1473,812,661
4202107,BARRA VELHA,SC,SUL,19897,14869,5028
4202131,BELA VISTA DO TOLDO,SC,SUL,4183,2706,1477
4202156,BELMONTE,SC,SUL,1931,1165,766
4202206,BENEDITO NOVO,SC,SUL,6689,5600,1089
4202305,BIGUAÇU,SC,SUL,41696,27499,14197
4202404,BLUMENAU,SC,SUL,211548,159256,52292
4202438,BOCAINA DO SUL,SC,SUL,2581,1575,1006
4202453,BOMBINHAS,SC,SUL,12990,9324,3666
4202503,BOM JARDIM DA SERRA,SC,SUL,2860,1597,1263
4202537,BOM JESUS,SC,SUL,2075,1091,984
4202578,BOM JESUS DO OESTE,SC,SUL,1623,1060,563
4202602,BOM RETIRO,SC,SUL,5128,3236,1892
4202701,BOTUVERÁ,SC,SUL,3735,2956,779
4202800,BRAÇO DO NORTE,SC,SUL,20436,16518,3918
4202859,BRAÇO DO TROMBUDO,SC,SUL,2720,2210,510
4202875,BRUNÓPOLIS,SC,SUL,2258,1236,1022
4202909,BRUSQUE,SC,SUL,78869,61992,16877
4203006,CAÇADOR,SC,SUL,40755,24290,16465
4203105,CAIBI,SC,SUL,4133,2957,1176
4203154,CALMON,SC,SUL,2310,792,1518
4203204,CAMBORIÚ,SC,SUL,44379,32194,12185
4203253,CAPÃO ALTO,SC,SUL,2303,1472,831
4203303,CAMPO ALEGRE,SC,SUL,7953,6355,1598
4203402,CAMPO BELO DO SUL,SC,SUL,4803,2496,2307
4203501,CAMPO ERÊ,SC,SUL,5718,2619,3099
4203600,CAMPOS NOVOS,SC,SUL,20762,13785,6977
4203709,CANELINHA,SC,SUL,7460,5579,1881
4203808,CANOINHAS,SC,SUL,33033,23038,9995
4203907,CAPINZAL,SC,SUL,13934,8873,5061
4203956,CAPIVARI DE BAIXO,SC,SUL,14150,9344,4806
4204004,CATANDUVAS,SC,SUL,6832,4293,2539
4204103,CAXAMBU DO SUL,SC,SUL,3684,1805,1879
4204152,CELSO RAMOS,SC,SUL,2125,1233,892
4204178,CERRO NEGRO,SC,SUL,2581,1012,1569
4204194,CHAPADÃO DO LAGEADO,SC,SUL,2264,1541,723
4204202,CHAPECÓ,SC,SUL,129937,81666,48271
4204251,COCAL DO SUL,SC,SUL,11259,8477,2782
4204301,CONCÓRDIA,SC,SUL,48222,34006,14216
4204350,CORDILHEIRA ALTA,SC,SUL,3398,2232,1166
4204400,CORONEL FREITAS,SC,SUL,6823,4185,2638
4204459,CORONEL MARTINS,SC,SUL,1656,885,771
4204509,CORUPÁ,SC,SUL,9761,7653,2108
4204558,CORREIA PINTO,SC,SUL,9726,5524,4202
4204608,CRICIÚMA,SC,SUL,118702,85502,33200
4204707,CUNHA PORÃ,SC,SUL,7400,6192,1208
4204756,CUNHATAÍ,SC,SUL,1509,1028,481
4204806,CURITIBANOS,SC,SUL,23644,14559,9085
4204905,DESCANSO,SC,SUL,5876,3753,2123
4205001,DIONÍSIO CERQUEIRA,SC,SUL,8553,4749,3804
4205100,DONA EMMA,SC,SUL,2675,1931,744
4205159,DOUTOR PEDRINHO,SC,SUL,2460,1987,473
4205175,ENTRE RIOS,SC,SUL,2378,731,1647
4205191,ERMO,SC,SUL,1933,1435,498
4205209,ERVAL VELHO,SC,SUL,3247,2311,936
4205308,FAXINAL DOS GUEDES,SC,SUL,7273,3657,3616
4205357,FLOR DO SERTÃO,SC,SUL,1394,699,695
4205407,FLORIANÓPOLIS,SC,SUL,317839,169495,148344
4205431,FORMOSA DO SUL,SC,SUL,2019,1010,1009
4205456,FORQUILHINHA,SC,SUL,16993,12462,4531
4205506,FRAIBURGO,SC,SUL,21265,13748,7517
4205555,FREI ROGÉRIO,SC,SUL,1819,1103,716
4205605,GALVÃO,SC,SUL,2244,1295,949
4205704,GAROPABA,SC,SUL,16817,10197,6620
4205803,GARUVA,SC,SUL,9578,7045,2533
4205902,GASPAR,SC,SUL,39439,29558,9881
4206009,GOVERNADOR CELSO RAMOS,SC,SUL,12062,9277,2785
4206108,GRÃO PARÁ,SC,SUL,4768,3740,1028
4206207,GRAVATAL,SC,SUL,7425,5692,1733
4206306,GUABIRUBA,SC,SUL,13811,11006,2805
4206405,GUARACIABA,SC,SUL,7487,4476,3011
4206504,GUARAMIRIM,SC,SUL,25910,19548,6362
4206603,GUARUJÁ DO SUL,SC,SUL,3264,2045,1219
4206652,GUATAMBÚ,SC,SUL,4904,2241,2663
4206702,HERVAL D'OESTE,SC,SUL,13466,9037,4429
4206751,IBIAM,SC,SUL,1572,1022,550
4206801,IBICARÉ,SC,SUL,2451,1802,649
4206900,IBIRAMA,SC,SUL,11862,9134,2728
4207007,IÇARA,SC,SUL,33499,24810,8689
4207106,ILHOTA,SC,SUL,8977,6928,2049
4207205,IMARUÍ,SC,SUL,7532,4072,3460
4207304,IMBITUBA,SC,SUL,29455,17277,12178
4207403,IMBUIA,SC,SUL,4219,3140,1079
4207502,INDAIAL,SC,SUL,38101,30063,8038
4207577,IOMERÊ,SC,SUL,2323,1779,544
4207601,IPIRA,SC,SUL,3163,1869,1294
4207650,IPORÃ DO OESTE,SC,SUL,6092,4201,1891
4207684,IPUAÇU,SC,SUL,4509,1499,3010
4207700,IPUMIRIM,SC,SUL,5007,2788,2219
4207759,IRACEMINHA,SC,SUL,3057,2183,874
4207809,IRANI,SC,SUL,6252,3936,2316
4207858,IRATI,SC,SUL,1692,846,846
4207908,IRINEÓPOLIS,SC,SUL,6479,4194,2285
4208005,ITÁ,SC,SUL,4820,2658,2162
4208104,ITAIÓPOLIS,SC,SUL,13376,9974,3402
4208203,ITAJAÍ,SC,SUL,133669,97531,36138
4208302,ITAPEMA,SC,SUL,39137,29868,9269
4208401,ITAPIRANGA,SC,SUL,10079,7199,2880
4208450,ITAPOÁ,SC,SUL,13446,9373,4073
4208500,ITUPORANGA,SC,SUL,16017,12643,3374
4208609,JABORÁ,SC,SUL,3237,2317,920
4208708,JACINTO MACHADO,SC,SUL,7418,5573,1845
4208807,JAGUARUNA,SC,SUL,12168,8893,3275
4208906,JARAGUÁ DO SUL,SC,SUL,104007,80164,23843
4208955,JARDINÓPOLIS,SC,SUL,1405,852,553
4209003,JOAÇABA,SC,SUL,18063,13104,4959
4209102,JOINVILLE,SC,SUL,349965,268079,81886
4209151,JOSÉ BOITEUX,SC,SUL,3522,2191,1331
4209177,JUPIÁ,SC,SUL,1854,1027,827
4209201,LACERDÓPOLIS,SC,SUL,1722,1284,438
4209300,LAGES,SC,SUL,98414,65883,32531
4209409,LAGUNA,SC,SUL,27445,16836,10609
4209458,LAJEADO GRANDE,SC,SUL,1282,797,485
4209508,LAURENTINO,SC,SUL,5077,3941,1136
4209607,LAURO MULLER,SC,SUL,9816,6405,3411
4209706,LEBON RÉGIS,SC,SUL,6654,3030,3624
4209805,LEOBERTO LEAL,SC,SUL,2656,1827,829
4209854,LINDÓIA DO SUL,SC,SUL,2953,1954,999
4209904,LONTRAS,SC,SUL,7319,5584,1735
4210001,LUIZ ALVES,SC,SUL,8364,6747,1617
4210035,LUZERNA,SC,SUL,4252,3364,888
4210050,MACIEIRA,SC,SUL,1439,757,682
4210100,MAFRA,SC,SUL,34096,25493,8603
4210209,MAJOR GERCINO,SC,SUL,2531,1835,696
4210308,MAJOR VIEIRA,SC,SUL,4791,2820,1971
4210407,MARACAJÁ,SC,SUL,5144,3427,1717
4210506,MARAVILHA,SC,SUL,16020,11285,4735
4210555,MAREMA,SC,SUL,1717,1131,586
4210605,MASSARANDUBA,SC,SUL,10926,8899,2027
4210704,MATOS COSTA,SC,SUL,1797,838,959
4210803,MELEIRO,SC,SUL,5094,4072,1022
4210852,MIRIM DOCE,SC,SUL,1939,1350,589
4210902,MODELO,SC,SUL,2883,1823,1060
4211009,MONDAÍ,SC,SUL,6227,3807,2420
4211058,MONTE CARLO,SC,SUL,5568,2772,2796
4211108,MONTE CASTELO,SC,SUL,5477,3216,2261
4211207,MORRO DA FUMAÇA,SC,SUL,11062,8841,2221
4211256,MORRO GRANDE,SC,SUL,2281,1789,492
4211306,NAVEGANTES,SC,SUL,45461,31871,13590
4211405,NOVA ERECHIM,SC,SUL,3297,1983,1314
4211454,NOVA ITABERABA,SC,SUL,3386,1734,1652
4211504,NOVA TRENTO,SC,SUL,9004,7066,1938
4211603,NOVA VENEZA,SC,SUL,10215,7889,2326
4211652,NOVO HORIZONTE,SC,SUL,2116,895,1221
4211702,ORLEANS,SC,SUL,15450,12264,3186
4211751,OTACÍLIO COSTA,SC,SUL,10749,7068,3681
4211801,OURO,SC,SUL,4831,3436,1395
4211850,OURO VERDE,SC,SUL,1649,1048,601
4211876,PAIAL,SC,SUL,1569,765,804
4211892,PAINEL,SC,SUL,1957,1087,870
4211900,PALHOÇA,SC,SUL,110918,72870,38048
4212007,PALMA SOLA,SC,SUL,4442,2134,2308
4212056,PALMEIRA,SC,SUL,2296,1442,854
4212106,PALMITOS,SC,SUL,10024,7062,2962
4212205,PAPANDUVA,SC,SUL,12010,6883,5127
4212239,PARAÍSO,SC,SUL,2963,1486,1477
4212254,PASSO DE TORRES,SC,SUL,5681,3632,2049
4212270,PASSOS MAIA,SC,SUL,2722,1228,1494
4212304,PAULO LOPES,SC,SUL,5482,3588,1894
4212403,PEDRAS GRANDES,SC,SUL,3332,2578,754
4212502,PENHA,SC,SUL,17465,13120,4345
4212601,PERITIBA,SC,SUL,2334,1710,624
4212650,PESCARIA BRAVA,SC,SUL,6513,3898,2615
4212700,PETROLÂNDIA,SC,SUL,4595,3579,1016
4212809,BALNEÁRIO PIÇARRAS,SC,SUL,14365,10532,3833
4212908,PINHALZINHO,SC,SUL,12697,7754,4943
4213005,PINHEIRO PRETO,SC,SUL,2371,1521,850
4213104,PIRATUBA,SC,SUL,4273,2856,1417
4213153,PLANALTO ALEGRE,SC,SUL,2349,1131,1218
4213203,POMERODE,SC,SUL,20577,16570,4007
4213302,PONTE ALTA,SC,SUL,3227,1942,1285
4213351,PONTE ALTA DO NORTE,SC,SUL,2011,1124,887
4213401,PONTE SERRADA,SC,SUL,6483,3320,3163
4213500,PORTO BELO,SC,SUL,12728,9455,3273
4213609,PORTO UNIÃO,SC,SUL,19565,13254,6311
4213708,POUSO REDONDO,SC,SUL,9718,7517,2201
4213807,PRAIA GRANDE,SC,SUL,5137,3031,2106
4213906,PRESIDENTE CASTELLO BRANCO,SC,SUL,1400,1102,298
4214003,PRESIDENTE GETÚLIO,SC,SUL,11190,8798,2392
4214102,PRESIDENTE NEREU,SC,SUL,1766,1257,509
4214151,PRINCESA,SC,SUL,2115,1325,790
4214201,QUILOMBO,SC,SUL,6914,3811,3103
4214300,RANCHO QUEIMADO,SC,SUL,2619,1876,743
4214409,RIO DAS ANTAS,SC,SUL,4146,2925,1221
4214508,RIO DO CAMPO,SC,SUL,4534,3436,1098
4214607,RIO DO OESTE,SC,SUL,5074,3662,1412
4214706,RIO DOS CEDROS,SC,SUL,7182,5678,1504
4214805,RIO DO SUL,SC,SUL,40860,31258,9602
4214904,RIO FORTUNA,SC,SUL,3864,3280,584
4215000,RIO NEGRINHO,SC,SUL,24785,18782,6003
4215059,RIO RUFINO,SC,SUL,1870,1174,696
4215075,RIQUEZA,SC,SUL,3350,1977,1373
4215109,RODEIO,SC,SUL,7901,6303,1598
4215208,ROMELÂNDIA,SC,SUL,3295,1821,1474
4215307,SALETE,SC,SUL,5019,3776,1243
4215356,SALTINHO,SC,SUL,2593,1011,1582
4215406,SALTO VELOSO,SC,SUL,2857,1983,874
4215455,SANGÃO,SC,SUL,6969,5565,1404
4215505,SANTA CECÍLIA,SC,SUL,9379,5514,3865
4215554,SANTA HELENA,SC,SUL,1898,1068,830
4215604,SANTA ROSA DE LIMA,SC,SUL,1668,1149,519
4215653,SANTA ROSA DO SUL,SC,SUL,6019,4296,1723
4215679,SANTA TEREZINHA,SC,SUL,5426,3800,1626
4215687,SANTA TEREZINHA DO PROGRESSO,SC,SUL,1926,823,1103
4215695,SANTIAGO DO SUL,SC,SUL,1242,651,591
4215703,SANTO AMARO DA IMPERATRIZ,SC,SUL,15798,10896,4902
4215752,SÃO BERNARDINO,SC,SUL,2029,954,1075
4215802,SÃO BENTO DO SUL,SC,SUL,50473,39161,11312
4215901,SÃO BONIFÁCIO,SC,SUL,2342,1906,436
4216008,SÃO CARLOS,SC,SUL,6898,4360,2538
4216057,SÃO CRISTOVÃO DO SUL,SC,SUL,2589,1507,1082
4216107,SÃO DOMINGOS,SC,SUL,6134,3507,2627
4216206,SÃO FRANCISCO DO SUL,SC,SUL,29536,20615,8921
4216255,SÃO JOÃO DO OESTE,SC,SUL,4319,3304,1015
4216305,SÃO JOÃO BATISTA,SC,SUL,18102,14256,3846
4216354,SÃO JOÃO DO ITAPERIÚ,SC,SUL,3075,2504,571
4216404,SÃO JOÃO DO SUL,SC,SUL,5557,3985,1572
4216503,SÃO JOAQUIM,SC,SUL,14821,8950,5871
4216602,SÃO JOSÉ,SC,SUL,148341,93707,54634
4216701,SÃO JOSÉ DO CEDRO,SC,SUL,9227,6519,2708
4216800,SÃO JOSÉ DO CERRITO,SC,SUL,6165,2862,3303
4216909,SÃO LOURENÇO DO OESTE,SC,SUL,15090,9604,5486
4217006,SÃO LUDGERO,SC,SUL,7789,6204,1585
4217105,SÃO MARTINHO,SC,SUL,2795,2263,532
4217154,SÃO MIGUEL DA BOA VISTA,SC,SUL,1407,690,717
4217204,SÃO MIGUEL DO OESTE,SC,SUL,25192,16594,8598
4217253,SÃO PEDRO DE ALCÂNTARA,SC,SUL,3495,2528,967
4217303,SAUDADES,SC,SUL,6551,4238,2313
4217402,SCHROEDER,SC,SUL,11441,8845,2596
4217501,SEARA,SC,SUL,11628,6610,5018
4217550,SERRA ALTA,SC,SUL,2431,1612,819
4217600,SIDERÓPOLIS,SC,SUL,8626,5828,2798
4217709,SOMBRIO,SC,SUL,17913,12668,5245
4217758,SUL BRASIL,SC,SUL,2093,1122,971
4217808,TAIÓ,SC,SUL,11895,9545,2350
4217907,TANGARÁ,SC,SUL,5450,3944,1506
4217956,TIGRINHOS,SC,SUL,1645,875,770
4218004,TIJUCAS,SC,SUL,24525,17585,6940
4218103,TIMBÉ DO SUL,SC,SUL,3656,2658,998
4218202,TIMBÓ,SC,SUL,27639,22756,4883
4218251,TIMBÓ GRANDE,SC,SUL,4242,2172,2070
4218301,TRÊS BARRAS,SC,SUL,11406,7106,4300
4218350,TREVISO,SC,SUL,3131,2008,1123
4218400,TREZE DE MAIO,SC,SUL,5534,4594,940
4218509,TREZE TÍLIAS,SC,SUL,5135,4008,1127
4218608,TROMBUDO CENTRAL,SC,SUL,4439,3548,891
4218707,TUBARÃO,SC,SUL,63764,47779,15985
4218756,TUNÁPOLIS,SC,SUL,3403,2571,832
4218806,TURVO,SC,SUL,8543,7034,1509
4218855,UNIÃO DO OESTE,SC,SUL,2083,1282,801
4218905,URUBICI,SC,SUL,6487,4675,1812
4218954,URUPEMA,SC,SUL,1933,1166,767
4219002,URUSSANGA,SC,SUL,13229,10265,2964
4219101,VARGEÃO,SC,SUL,2468,1338,1130
4219150,VARGEM,SC,SUL,2024,1054,970
4219176,VARGEM BONITA,SC,SUL,3314,1941,1373
4219200,VIDAL RAMOS,SC,SUL,4514,3285,1229
4219309,VIDEIRA,SC,SUL,30429,21928,8501
4219358,VITOR MEIRELES,SC,SUL,3615,2525,1090
4219408,WITMARSUM,SC,SUL,2809,2021,788
4219507,XANXERÊ,SC,SUL,28907,17718,11189
4219606,XAVANTINA,SC,SUL,3067,1752,1315
4219705,XAXIM,SC,SUL,18605,12416,6189
4219853,ZORTÉA,SC,SUL,2526,1473,1053
4220000,BALNEÁRIO RINCÃO,SC,SUL,9371,6130,3241
4300034,ACEGUÁ,RS,SUL,2961,1753,1208
4300059,ÁGUA SANTA,RS,SUL,2683,1868,815
4300109,AGUDO,RS,SUL,10564,6146,4418
4300208,AJURICABA,RS,SUL,4929,3269,1660
4300307,ALECRIM,RS,SUL,4542,2411,2131
4300406,ALEGRETE,RS,SUL,41201,19414,21787
4300455,ALEGRIA,RS,SUL,2680,1374,1306
4300471,ALMIRANTE TAMANDARÉ DO SUL,RS,SUL,1616,994,622
4300505,ALPESTRE,RS,SUL,4947,2446,2501
4300554,ALTO ALEGRE,RS,SUL,1464,648,816
4300570,ALTO FELIZ,RS,SUL,2253,1700,553
4300604,ALVORADA,RS,SUL,103187,51956,51231
4300638,AMARAL FERRADOR,RS,SUL,3503,1757,1746
4300646,AMETISTA DO SUL,RS,SUL,4918,2797,2121
4300661,ANDRÉ DA ROCHA,RS,SUL,1053,733,320
4300703,ANTA GORDA,RS,SUL,4043,3325,718
4300802,ANTÔNIO PRADO,RS,SUL,9015,7241,1774
4300851,ARAMBARÉ,RS,SUL,2605,1389,1216
4300877,ARARICÁ,RS,SUL,4675,3117,1558
4300901,ARATIBA,RS,SUL,5253,3018,2235
4301008,ARROIO DO MEIO,RS,SUL,13631,9260,4371
4301057,ARROIO DO SAL,RS,SUL,6007,3816,2191
4301073,ARROIO DO PADRE,RS,SUL,2311,1922,389
4301107,ARROIO DOS RATOS,RS,SUL,7727,3574,4153
4301206,ARROIO DO TIGRE,RS,SUL,8291,4783,3508
4301305,ARROIO GRANDE,RS,SUL,11312,4230,7082
4301404,ARVOREZINHA,RS,SUL,7108,4714,2394
4301503,AUGUSTO PESTANA,RS,SUL,5014,3432,1582
4301552,ÁUREA,RS,SUL,2718,1634,1084
4301602,BAGÉ,RS,SUL,65752,30449,35303
4301636,BALNEÁRIO PINHAL,RS,SUL,6821,3623,3198
4301651,BARÃO,RS,SUL,4218,3048,1170
4301701,BARÃO DE COTEGIPE,RS,SUL,4527,2751,1776
4301750,BARÃO DO TRIUNFO,RS,SUL,3622,2245,1377
4301800,BARRACÃO,RS,SUL,3407,1745,1662
4301859,BARRA DO GUARITA,RS,SUL,2039,948,1091
4301875,BARRA DO QUARAÍ,RS,SUL,2220,1000,1220
4301909,BARRA DO RIBEIRO,RS,SUL,7686,4089,3597
4301925,BARRA DO RIO AZUL,RS,SUL,1450,782,668
4301958,BARRA FUNDA,RS,SUL,2266,1322,944
4302006,BARROS CASSAL,RS,SUL,6437,2966,3471
4302055,BENJAMIN CONSTANT DO SUL,RS,SUL,1656,646,1010
4302105,BENTO GONÇALVES,RS,SUL,73844,55971,17873
4302154,BOA VISTA DAS MISSÕES,RS,SUL,1573,757,816
4302204,BOA VISTA DO BURICÁ,RS,SUL,4720,3057,1663
4302220,BOA VISTA DO CADEADO,RS,SUL,1696,1138,558
4302238,BOA VISTA DO INCRA,RS,SUL,1801,1083,718
4302253,BOA VISTA DO SUL,RS,SUL,2039,1531,508
4302303,BOM JESUS,RS,SUL,6308,3260,3048
4302352,BOM PRINCÍPIO,RS,SUL,8700,6757,1943
4302378,BOM PROGRESSO,RS,SUL,1781,860,921
4302402,BOM RETIRO DO SUL,RS,SUL,7821,4991,2830
4302451,BOQUEIRÃO DO LEÃO,RS,SUL,4487,2455,2032
4302501,BOSSOROCA,RS,SUL,3862,1633,2229
4302584,BOZANO,RS,SUL,2025,1323,702
4302600,BRAGA,RS,SUL,2181,877,1304
4302659,BROCHIER,RS,SUL,3222,1986,1236
4302709,BUTIÁ,RS,SUL,11301,4955,6346
4302808,CAÇAPAVA DO SUL,RS,SUL,19061,7096,11965
4302907,CACEQUI,RS,SUL,6425,2897,3528
4303004,CACHOEIRA DO SUL,RS,SUL,47512,28555,18957
4303103,CACHOEIRINHA,RS,SUL,78990,46256,32734
4303202,CACIQUE DOBLE,RS,SUL,3288,1998,1290
4303301,CAIBATÉ,RS,SUL,3244,1520,1724
4303400,CAIÇARA,RS,SUL,3534,2098,1436
4303509,CAMAQUÃ,RS,SUL,38396,22770,15626
4303558,CAMARGO,RS,SUL,2105,1358,747
4303608,CAMBARÁ DO SUL,RS,SUL,3920,2580,1340
4303673,CAMPESTRE DA SERRA,RS,SUL,2209,1777,432
4303707,CAMPINA DAS MISSÕES,RS,SUL,4243,2374,1869
4303806,CAMPINAS DO SUL,RS,SUL,3885,2869,1016
4303905,CAMPO BOM,RS,SUL,41702,28341,13361
4304002,CAMPO NOVO,RS,SUL,3157,1535,1622
4304101,CAMPOS BORGES,RS,SUL,2524,1361,1163
4304200,CANDELÁRIA,RS,SUL,17573,10324,7249
4304309,CÂNDIDO GODÓI,RS,SUL,4862,3378,1484
4304358,CANDIOTA,RS,SUL,6064,1974,4090
4304408,CANELA,RS,SUL,25417,16937,8480
4304507,CANGUÇU,RS,SUL,32906,19270,13636
4304606,CANOAS,RS,SUL,196994,108143,88851
4304614,CANUDOS DO VALE,RS,SUL,1535,654,881
4304622,CAPÃO BONITO DO SUL,RS,SUL,1662,802,860
4304630,CAPÃO DA CANOA,RS,SUL,31801,20498,11303
4304655,CAPÃO DO CIPÓ,RS,SUL,2274,989,1285
4304663,CAPÃO DO LEÃO,RS,SUL,13899,5956,7943
4304671,CAPIVARI DO SUL,RS,SUL,2863,1680,1183
4304689,CAPELA DE SANTANA,RS,SUL,6338,3472,2866
4304697,CAPITÃO,RS,SUL,2272,1396,876
4304705,CARAZINHO,RS,SUL,36846,22264,14582
4304713,CARAÁ,RS,SUL,4733,2577,2156
4304804,CARLOS BARBOSA,RS,SUL,19409,14478,4931
4304853,CARLOS GOMES,RS,SUL,1177,586,591
4304903,CASCA,RS,SUL,6305,4557,1748
4304952,CASEIROS,RS,SUL,2511,1502,1009
4305009,CATUÍPE,RS,SUL,6260,3579,2681
4305108,CAXIAS DO SUL,RS,SUL,271854,180592,91262
4305116,CENTENÁRIO,RS,SUL,2291,1210,1081
4305124,CERRITO,RS,SUL,4134,1636,2498
4305132,CERRO BRANCO,RS,SUL,2838,1722,1116
4305157,CERRO GRANDE,RS,SUL,2245,958,1287
4305173,CERRO GRANDE DO SUL,RS,SUL,5552,2915,2637
4305207,CERRO LARGO,RS,SUL,8196,4097,4099
4305306,CHAPADA,RS,SUL,6523,4072,2451
4305355,CHARQUEADAS,RS,SUL,19570,8870,10700
4305371,CHARRUA,RS,SUL,2019,1039,980
4305405,CHIAPETTA,RS,SUL,2836,1577,1259
4305439,CHUÍ,RS,SUL,3041,1068,1973
4305447,CHUVISCA,RS,SUL,3511,2356,1155
4305454,CIDREIRA,RS,SUL,7807,3923,3884
4305504,CIRÍACO,RS,SUL,3048,1800,1248
4305587,COLINAS,RS,SUL,1839,1233,606
4305603,COLORADO,RS,SUL,2522,1782,740
4305702,CONDOR,RS,SUL,4607,2871,1736
4305801,CONSTANTINA,RS,SUL,6752,3776,2976
4305835,COQUEIRO BAIXO,RS,SUL,1102,870,232
4305850,COQUEIROS DO SUL,RS,SUL,1975,1305,670
4305871,CORONEL BARROS,RS,SUL,2135,1396,739
4305900,CORONEL BICACO,RS,SUL,4685,2255,2430
4305934,CORONEL PILAR,RS,SUL,1250,975,275
4305959,COTIPORÃ,RS,SUL,2929,2261,668
4305975,COXILHA,RS,SUL,2252,1269,983
4306007,CRISSIUMAL,RS,SUL,8434,4644,3790
4306056,CRISTAL,RS,SUL,4766,2491,2275
4306072,CRISTAL DO SUL,RS,SUL,2062,925,1137
4306106,CRUZ ALTA,RS,SUL,35549,19195,16354
4306130,CRUZALTENSE,RS,SUL,1683,1142,541
4306205,CRUZEIRO DO SUL,RS,SUL,7756,5021,2735
4306304,DAVID CANABARRO,RS,SUL,3325,2021,1304
4306320,DERRUBADAS,RS,SUL,2164,1130,1034
4306353,DEZESSEIS DE NOVEMBRO,RS,SUL,1991,886,1105
4306379,DILERMANDO DE AGUIAR,RS,SUL,2358,1267,1091
4306403,DOIS IRMÃOS,RS,SUL,20404,13698,6706
4306429,DOIS IRMÃOS DAS MISSÕES,RS,SUL,1584,749,835
4306452,DOIS LAJEADOS,RS,SUL,2488,1907,581
4306502,DOM FELICIANO,RS,SUL,8018,3746,4272
4306551,DOM PEDRO DE ALCÂNTARA,RS,SUL,2032,1273,759
4306601,DOM PEDRITO,RS,SUL,21197,9878,11319
4306700,DONA FRANCISCA,RS,SUL,2408,1316,1092
4306734,DOUTOR MAURÍCIO CARDOSO,RS,SUL,3244,2103,1141
4306759,DOUTOR RICARDO,RS,SUL,1703,1201,502
4306767,ELDORADO DO SUL,RS,SUL,20346,10436,9910
4306809,ENCANTADO,RS,SUL,13762,9544,4218
4306908,ENCRUZILHADA DO SUL,RS,SUL,14253,5840,8413
4306924,ENGENHO VELHO,RS,SUL,953,419,534
4306932,ENTRE-IJUÍS,RS,SUL,5871,3187,2684
4306957,ENTRE RIOS DO SUL,RS,SUL,2081,1052,1029
4306973,EREBANGO,RS,SUL,2052,1249,803
4307005,ERECHIM,RS,SUL,64057,42893,21164
4307054,ERNESTINA,RS,SUL,2340,1298,1042
4307104,HERVAL,RS,SUL,3788,1203,2585
4307203,ERVAL GRANDE,RS,SUL,3417,1600,1817
4307302,ERVAL SECO,RS,SUL,4436,2061,2375
4307401,ESMERALDA,RS,SUL,2103,1153,950
4307450,ESPERANÇA DO SUL,RS,SUL,2417,1077,1340
4307500,ESPUMOSO,RS,SUL,10313,5978,4335
4307559,ESTAÇÃO,RS,SUL,4025,2768,1257
4307609,ESTÂNCIA VELHA,RS,SUL,29351,20924,8427
4307708,ESTEIO,RS,SUL,51284,26136,25148
4307807,ESTRELA,RS,SUL,20001,14439,5562
4307815,ESTRELA VELHA,RS,SUL,2378,1330,1048
4307831,EUGÊNIO DE CASTRO,RS,SUL,1971,1181,790
4307864,FAGUNDES VARELA,RS,SUL,2063,1633,430
4307906,FARROUPILHA,RS,SUL,46087,34359,11728
4308003,FAXINAL DO SOTURNO,RS,SUL,4577,2743,1834
4308052,FAXINALZINHO,RS,SUL,1873,1126,747
4308078,FAZENDA VILANOVA,RS,SUL,2725,1593,1132
4308102,FELIZ,RS,SUL,8970,6148,2822
4308201,FLORES DA CUNHA,RS,SUL,20601,16910,3691
4308250,FLORIANO PEIXOTO,RS,SUL,1520,833,687
4308300,FONTOURA XAVIER,RS,SUL,6404,2720,3684
4308409,FORMIGUEIRO,RS,SUL,4320,2062,2258
4308433,FORQUETINHA,RS,SUL,2005,1369,636
4308458,FORTALEZA DOS VALOS,RS,SUL,3148,1791,1357
4308508,FREDERICO WESTPHALEN,RS,SUL,20152,12234,7918
4308607,GARIBALDI,RS,SUL,21705,16455,5250
4308656,GARRUCHOS,RS,SUL,1951,732,1219
4308706,GAURAMA,RS,SUL,4339,2964,1375
4308805,GENERAL CÂMARA,RS,SUL,4832,2311,2521
4308854,GENTIL,RS,SUL,1337,996,341
4308904,GETÚLIO VARGAS,RS,SUL,10242,7346,2896
4309001,GIRUÁ,RS,SUL,10404,6709,3695
4309050,GLORINHA,RS,SUL,5096,3446,1650
4309100,GRAMADO,RS,SUL,25604,19160,6444
4309126,GRAMADO DOS LOUREIROS,RS,SUL,1785,741,1044
4309159,GRAMADO XAVIER,RS,SUL,2388,1093,1295
4309209,GRAVATAÍ,RS,SUL,144949,87219,57730
4309258,GUABIJU,RS,SUL,1168,878,290
4309308,GUAÍBA,RS,SUL,57074,28599,28475
4309407,GUAPORÉ,RS,SUL,15643,11775,3868
4309506,GUARANI DAS MISSÕES,RS,SUL,4937,2692,2245
4309555,HARMONIA,RS,SUL,3382,2418,964
4309571,HERVEIRAS,RS,SUL,2062,764,1298
4309605,HORIZONTINA,RS,SUL,11769,8192,3577
4309654,HULHA NEGRA,RS,SUL,3731,1439,2292
4309704,HUMAITÁ,RS,SUL,3420,1999,1421
4309753,IBARAMA,RS,SUL,2907,1529,1378
4309803,IBIAÇÁ,RS,SUL,3282,2180,1102
4309902,IBIRAIARAS,RS,SUL,4548,3270,1278
4309951,IBIRAPUITÃ,RS,SUL,2879,1580,1299
4310009,IBIRUBÁ,RS,SUL,13550,9271,4279
4310108,IGREJINHA,RS,SUL,22149,14939,7210
4310207,IJUÍ,RS,SUL,51489,30188,21301
4310306,ILÓPOLIS,RS,SUL,2890,2231,659
4310330,IMBÉ,RS,SUL,14917,8625,6292
4310363,IMIGRANTE,RS,SUL,2081,1384,697
4310405,INDEPENDÊNCIA,RS,SUL,4549,2796,1753
4310413,INHACORÁ,RS,SUL,1537,762,775
4310439,IPÊ,RS,SUL,4526,3509,1017
4310462,IPIRANGA DO SUL,RS,SUL,1678,1320,358
4310504,IRAÍ,RS,SUL,4707,2342,2365
4310538,ITAARA,RS,SUL,3478,1966,1512
4310553,ITACURUBI,RS,SUL,2043,1008,1035
4310579,ITAPUCA,RS,SUL,1427,874,553
4310603,ITAQUI,RS,SUL,19424,10523,8901
4310652,ITATI,RS,SUL,2621,1494,1127
4310702,ITATIBA DO SUL,RS,SUL,2869,1186,1683
4310751,IVORÁ,RS,SUL,1434,730,704
4310801,IVOTI,RS,SUL,14119,10110,4009
4310850,JABOTICABA,RS,SUL,2611,1302,1309
4310876,JACUIZINHO,RS,SUL,1627,729,898
4310900,JACUTINGA,RS,SUL,2451,1570,881
4311007,JAGUARÃO,RS,SUL,15129,6414,8715
4311106,JAGUARI,RS,SUL,6973,3929,3044
4311122,JAQUIRANA,RS,SUL,2639,1400,1239
4311130,JARI,RS,SUL,2267,977,1290
4311155,JÓIA,RS,SUL,5128,2321,2807
4311205,JÚLIO DE CASTILHOS,RS,SUL,11954,5278,6676
4311239,LAGOA BONITA DO SUL,RS,SUL,1879,894,985
4311254,LAGOÃO,RS,SUL,3615,1241,2374
4311270,LAGOA DOS TRÊS CANTOS,RS,SUL,1354,1012,342
4311304,LAGOA VERMELHA,RS,SUL,16114,9574,6540
4311403,LAJEADO,RS,SUL,48258,31987,16271
4311429,LAJEADO DO BUGRE,RS,SUL,1586,662,924
4311502,LAVRAS DO SUL,RS,SUL,4253,1669,2584
4311601,LIBERATO SALZANO,RS,SUL,3406,1436,1970
4311627,LINDOLFO COLLOR,RS,SUL,3769,2156,1613
4311643,LINHA NOVA,RS,SUL,1156,784,372
4311700,MACHADINHO,RS,SUL,3907,2344,1563
4311718,MAÇAMBARÁ,RS,SUL,2939,1535,1404
4311734,MAMPITUBA,RS,SUL,2337,1091,1246
4311759,MANOEL VIANA,RS,SUL,4257,1986,2271
4311775,MAQUINÉ,RS,SUL,4724,2255,2469
4311791,MARATÁ,RS,SUL,1940,1381,559
4311809,MARAU,RS,SUL,25952,18107,7845
4311908,MARCELINO RAMOS,RS,SUL,3164,1827,1337
4311981,MARIANA PIMENTEL,RS,SUL,2789,1659,1130
4312005,MARIANO MORO,RS,SUL,1773,907,866
4312054,MARQUES DE SOUZA,RS,SUL,2803,1825,978
4312104,MATA,RS,SUL,3142,1621,1521
4312138,MATO CASTELHANO,RS,SUL,2316,1764,552
4312153,MATO LEITÃO,RS,SUL,3208,2093,1115
4312179,MATO QUEIMADO,RS,SUL,1313,702,611
4312203,MAXIMILIANO DE ALMEIDA,RS,SUL,3243,2163,1080
4312252,MINAS DO LEÃO,RS,SUL,4876,2319,2557
4312302,MIRAGUAÍ,RS,SUL,3412,1477,1935
4312351,MONTAURI,RS,SUL,1238,948,290
4312377,MONTE ALEGRE DOS CAMPOS,RS,SUL,2510,1601,909
4312385,MONTE BELO DO SUL,RS,SUL,2581,2131,450
4312401,MONTENEGRO,RS,SUL,35897,21452,14445
4312427,MORMAÇO,RS,SUL,2176,1279,897
4312443,MORRINHOS DO SUL,RS,SUL,2617,1749,868
4312450,MORRO REDONDO,RS,SUL,4047,2380,1667
4312476,MORRO REUTER,RS,SUL,4549,3431,1118
4312500,MOSTARDAS,RS,SUL,6787,3800,2987
4312609,MUÇUM,RS,SUL,3361,2422,939
4312617,MUITOS CAPÕES,RS,SUL,2103,1462,641
4312625,MULITERNO,RS,SUL,1680,871,809
4312658,NÃO-ME-TOQUE,RS,SUL,10837,7522,3315
4312674,NICOLAU VERGUEIRO,RS,SUL,1743,1126,617
4312708,NONOAI,RS,SUL,7513,3811,3702
4312757,NOVA ALVORADA,RS,SUL,2339,1710,629
4312807,NOVA ARAÇÁ,RS,SUL,3263,2552,711
4312906,NOVA BASSANO,RS,SUL,6144,5151,993
4312955,NOVA BOA VISTA,RS,SUL,1712,1150,562
4313003,NOVA BRÉSCIA,RS,SUL,2296,1781,515
4313011,NOVA CANDELÁRIA,RS,SUL,2236,1480,756
4313037,NOVA ESPERANÇA DO SUL,RS,SUL,3342,1784,1558
4313060,NOVA HARTZ,RS,SUL,11969,7367,4602
4313086,NOVA PÁDUA,RS,SUL,2044,1819,225
4313102,NOVA PALMA,RS,SUL,4228,2340,1888
4313201,NOVA PETRÓPOLIS,RS,SUL,13767,10456,3311
4313300,NOVA PRATA,RS,SUL,15529,11957,3572
4313334,NOVA RAMADA,RS,SUL,1711,1053,658
4313359,NOVA ROMA DO SUL,RS,SUL,2629,2041,588
4313375,NOVA SANTA RITA,RS,SUL,14625,8152,6473
4313391,NOVO CABRAIS,RS,SUL,2938,1741,1197
4313409,NOVO HAMBURGO,RS,SUL,139933,95799,44134
4313425,NOVO MACHADO,RS,SUL,2631,1693,938
4313441,NOVO TIRADENTES,RS,SUL,1501,686,815
4313466,NOVO XINGU,RS,SUL,1314,665,649
4313490,NOVO BARREIRO,RS,SUL,3066,1471,1595
4313508,OSÓRIO,RS,SUL,28241,14629,13612
4313607,PAIM FILHO,RS,SUL,3204,1720,1484
4313656,PALMARES DO SUL,RS,SUL,7816,4318,3498
4313706,PALMEIRA DAS MISSÕES,RS,SUL,19316,10337,8979
4313805,PALMITINHO,RS,SUL,4907,2215,2692
4313904,PANAMBI,RS,SUL,26174,18425,7749
4313953,PANTANO GRANDE,RS,SUL,6368,2643,3725
4314001,PARAÍ,RS,SUL,5121,3888,1233
4314027,PARAÍSO DO SUL,RS,SUL,4420,2758,1662
4314035,PARECI NOVO,RS,SUL,2787,2107,680
4314050,PAROBÉ,RS,SUL,31321,20009,11312
4314068,PASSA SETE,RS,SUL,3030,1507,1523
4314076,PASSO DO SOBRADO,RS,SUL,4200,2324,1876
4314100,PASSO FUNDO,RS,SUL,117992,66922,51070
4314134,PAULO BENTO,RS,SUL,1791,1181,610
4314159,PAVERAMA,RS,SUL,4646,2788,1858
4314175,PEDRAS ALTAS,RS,SUL,1505,508,997
4314209,PEDRO OSÓRIO,RS,SUL,5079,1706,3373
4314308,PEJUÇARA,RS,SUL,2550,1567,983
4314407,PELOTAS,RS,SUL,191816,83962,107854
4314423,PICADA CAFÉ,RS,SUL,3634,2628,1006
4314456,PINHAL,RS,SUL,1919,1106,813
4314464,PINHAL DA SERRA,RS,SUL,1870,1048,822
4314472,PINHAL GRANDE,RS,SUL,2859,1319,1540
4314498,PINHEIRINHO DO VALE,RS,SUL,2990,1569,1421
4314506,PINHEIRO MACHADO,RS,SUL,7109,2335,4774
4314548,PINTO BANDEIRA,RS,SUL,2009,1677,332
4314555,PIRAPÓ,RS,SUL,1684,708,976
4314605,PIRATINI,RS,SUL,11285,4180,7105
4314704,PLANALTO,RS,SUL,6227,3448,2779
4314753,POÇO DAS ANTAS,RS,SUL,1627,1169,458
4314779,PONTÃO,RS,SUL,2798,1428,1370
4314787,PONTE PRETA,RS,SUL,1525,1020,505
4314803,PORTÃO,RS,SUL,20023,12331,7692
4314902,PORTO ALEGRE,RS,SUL,818297,380499,437798
4315008,PORTO LUCENA,RS,SUL,3153,1681,1472
4315057,PORTO MAUÁ,RS,SUL,1845,1189,656
4315073,PORTO VERA CRUZ,RS,SUL,1382,727,655
4315107,PORTO XAVIER,RS,SUL,6329,3319,3010
4315131,POUSO NOVO,RS,SUL,1378,772,606
4315149,PRESIDENTE LUCENA,RS,SUL,2200,1672,528
4315156,PROGRESSO,RS,SUL,4222,2235,1987
4315172,PROTÁSIO ALVES,RS,SUL,1615,1305,310
4315206,PUTINGA,RS,SUL,2953,2306,647
4315305,QUARAÍ,RS,SUL,13325,6491,6834
4315313,QUATRO IRMÃOS,RS,SUL,1371,857,514
4315321,QUEVEDOS,RS,SUL,1827,809,1018
4315354,QUINZE DE NOVEMBRO,RS,SUL,2994,2113,881
4315404,REDENTORA,RS,SUL,4909,1848,3061
4315453,RELVADO,RS,SUL,1641,1170,471
4315503,RESTINGA SECA,RS,SUL,9804,5495,4309
4315552,RIO DOS ÍNDIOS,RS,SUL,2271,951,1320
4315602,RIO GRANDE,RS,SUL,112254,39996,72258
4315701,RIO PARDO,RS,SUL,22009,9190,12819
4315750,RIOZINHO,RS,SUL,3289,1815,1474
4315800,ROCA SALES,RS,SUL,6378,4204,2174
4315909,RODEIO BONITO,RS,SUL,4228,2251,1977
4315958,ROLADOR,RS,SUL,1880,844,1036
4316006,ROLANTE,RS,SUL,13426,8717,4709
4316105,RONDA ALTA,RS,SUL,6134,2890,3244
4316204,RONDINHA,RS,SUL,3880,2224,1656
4316303,ROQUE GONZALES,RS,SUL,4467,2348,2119
4316402,ROSÁRIO DO SUL,RS,SUL,22757,10673,12084
4316428,SAGRADA FAMÍLIA,RS,SUL,1804,867,937
4316436,SALDANHA MARINHO,RS,SUL,2263,1426,837
4316451,SALTO DO JACUÍ,RS,SUL,6216,2926,3290
4316477,SALVADOR DAS MISSÕES,RS,SUL,2222,1366,856
4316501,SALVADOR DO SUL,RS,SUL,4632,3317,1315
4316600,SANANDUVA,RS,SUL,10958,7685,3273
4316709,SANTA BÁRBARA DO SUL,RS,SUL,5629,3543,2086
4316733,SANTA CECÍLIA DO SUL,RS,SUL,1564,1086,478
4316758,SANTA CLARA DO SUL,RS,SUL,4349,3084,1265
4316808,SANTA CRUZ DO SUL,RS,SUL,82907,49867,33040
4316907,SANTA MARIA,RS,SUL,159384,83340,76044
4316956,SANTA MARIA DO HERVAL,RS,SUL,4454,2911,1543
4316972,SANTA MARGARIDA DO SUL,RS,SUL,2064,1033,1031
4317004,SANTANA DA BOA VISTA,RS,SUL,4692,2207,2485
4317103,SANT'ANA DO LIVRAMENTO,RS,SUL,50002,21249,28753
4317202,SANTA ROSA,RS,SUL,45768,30871,14897
4317251,SANTA TEREZA,RS,SUL,1440,1051,389
4317301,SANTA VITÓRIA DO PALMAR,RS,SUL,16585,6213,10372
4317400,SANTIAGO,RS,SUL,29962,16482,13480
4317509,SANTO ÂNGELO,RS,SUL,45837,25061,20776
4317558,SANTO ANTÔNIO DO PALMA,RS,SUL,1602,872,730
4317608,SANTO ANTÔNIO DA PATRULHA,RS,SUL,25614,14651,10963
4317707,SANTO ANTÔNIO DAS MISSÕES,RS,SUL,6537,2545,3992
4317756,SANTO ANTÔNIO DO PLANALTO,RS,SUL,1742,1238,504
4317806,SANTO AUGUSTO,RS,SUL,8983,4761,4222
4317905,SANTO CRISTO,RS,SUL,10732,6187,4545
4317954,SANTO EXPEDITO DO SUL,RS,SUL,1849,1144,705
4318002,SÃO BORJA,RS,SUL,35307,15784,19523
4318051,SÃO DOMINGOS DO SUL,RS,SUL,2200,1410,790
4318101,SÃO FRANCISCO DE ASSIS,RS,SUL,11284,4950,6334
4318200,SÃO FRANCISCO DE PAULA,RS,SUL,12163,6289,5874
4318309,SÃO GABRIEL,RS,SUL,32875,15954,16921
4318408,SÃO JERÔNIMO,RS,SUL,12051,5593,6458
4318424,SÃO JOÃO DA URTIGA,RS,SUL,3463,2205,1258
4318432,SÃO JOÃO DO POLÊSINE,RS,SUL,2033,1330,703
4318440,SÃO JORGE,RS,SUL,2141,1707,434
4318457,SÃO JOSÉ DAS MISSÕES,RS,SUL,1807,716,1091
4318465,SÃO JOSÉ DO HERVAL,RS,SUL,1514,729,785
4318481,SÃO JOSÉ DO HORTÊNCIO,RS,SUL,3120,2483,637
4318499,SÃO JOSÉ DO INHACORÁ,RS,SUL,1912,1205,707
4318507,SÃO JOSÉ DO NORTE,RS,SUL,15644,6896,8748
4318606,SÃO JOSÉ DO OURO,RS,SUL,4861,3324,1537
4318614,SÃO JOSÉ DO SUL,RS,SUL,1648,1209,439
4318622,SÃO JOSÉ DOS AUSENTES,RS,SUL,2357,1525,832
4318705,SÃO LEOPOLDO,RS,SUL,126969,71028,55941
4318804,SÃO LOURENÇO DO SUL,RS,SUL,27208,15058,12150
4318903,SÃO LUIZ GONZAGA,RS,SUL,19595,9966,9629
4319000,SÃO MARCOS,RS,SUL,13480,10333,3147
4319109,SÃO MARTINHO,RS,SUL,4076,2649,1427
4319125,SÃO MARTINHO DA SERRA,RS,SUL,2390,1404,986
4319158,SÃO MIGUEL DAS MISSÕES,RS,SUL,4684,2226,2458
4319208,SÃO NICOLAU,RS,SUL,3168,1298,1870
4319307,SÃO PAULO DAS MISSÕES,RS,SUL,4243,2328,1915
4319356,SÃO PEDRO DA SERRA,RS,SUL,2691,2004,687
4319364,SÃO PEDRO DAS MISSÕES,RS,SUL,1275,596,679
4319372,SÃO PEDRO DO BUTIÁ,RS,SUL,2159,1334,825
4319406,SÃO PEDRO DO SUL,RS,SUL,10073,5562,4511
4319505,SÃO SEBASTIÃO DO CAÍ,RS,SUL,13972,8885,5087
4319604,SÃO SEPÉ,RS,SUL,13322,5709,7613
4319703,SÃO VALENTIM,RS,SUL,2564,1569,995
4319711,SÃO VALENTIM DO SUL,RS,SUL,1823,1387,436
4319737,SÃO VALÉRIO DO SUL,RS,SUL,1733,684,1049
4319752,SÃO VENDELINO,RS,SUL,1922,1372,550
4319802,SÃO VICENTE DO SUL,RS,SUL,5365,2593,2772
4319901,SAPIRANGA,RS,SUL,49755,31721,18034
4320008,SAPUCAIA DO SUL,RS,SUL,78811,38501,40310
4320107,SARANDI,RS,SUL,13943,8975,4968
4320206,SEBERI,RS,SUL,7487,4230,3257
4320230,SEDE NOVA,RS,SUL,2010,1038,972
4320263,SEGREDO,RS,SUL,4472,2337,2135
4320305,SELBACH,RS,SUL,3675,2585,1090
4320321,SENADOR SALGADO FILHO,RS,SUL,2238,1605,633
4320354,SENTINELA DO SUL,RS,SUL,3208,1595,1613
4320404,SERAFINA CORRÊA,RS,SUL,10415,7702,2713
4320453,SÉRIO,RS,SUL,1626,885,741
4320503,SERTÃO,RS,SUL,4123,2730,1393
4320552,SERTÃO SANTANA,RS,SUL,4225,2778,1447
4320578,SETE DE SETEMBRO,RS,SUL,1490,735,755
4320602,SEVERIANO DE ALMEIDA,RS,SUL,2808,1694,1114
4320651,SILVEIRA MARTINS,RS,SUL,1788,1069,719
4320677,SINIMBU,RS,SUL,5721,3072,2649
4320701,SOBRADINHO,RS,SUL,8702,4985,3717
4320800,SOLEDADE,RS,SUL,17359,9030,8329
4320859,TABAÍ,RS,SUL,3130,1758,1372
4320909,TAPEJARA,RS,SUL,14348,11109,3239
4321006,TAPERA,RS,SUL,6614,3842,2772
4321105,TAPES,RS,SUL,8740,4437,4303
4321204,TAQUARA,RS,SUL,32345,21697,10648
4321303,TAQUARI,RS,SUL,15458,8695,6763
4321329,TAQUARUÇU DO SUL,RS,SUL,2327,1243,1084
4321352,TAVARES,RS,SUL,3397,1712,1685
4321402,TENENTE PORTELA,RS,SUL,8266,3836,4430
4321436,TERRA DE AREIA,RS,SUL,5978,3588,2390
4321451,TEUTÔNIA,RS,SUL,19852,12726,7126
4321469,TIO HUGO,RS,SUL,2120,1241,879
4321477,TIRADENTES DO SUL,RS,SUL,3538,1604,1934
4321493,TOROPI,RS,SUL,2160,1298,862
4321501,TORRES,RS,SUL,23463,14267,9196
4321600,TRAMANDAÍ,RS,SUL,26384,14928,11456
4321626,TRAVESSEIRO,RS,SUL,1653,952,701
4321634,TRÊS ARROIOS,RS,SUL,2054,1401,653
4321667,TRÊS CACHOEIRAS,RS,SUL,6742,4858,1884
4321709,TRÊS COROAS,RS,SUL,14419,9808,4611
4321808,TRÊS DE MAIO,RS,SUL,14846,9889,4957
4321832,TRÊS FORQUILHAS,RS,SUL,2319,1250,1069
4321857,TRÊS PALMEIRAS,RS,SUL,3218,1453,1765
4321907,TRÊS PASSOS,RS,SUL,15124,8158,6966
4321956,TRINDADE DO SUL,RS,SUL,4233,2029,2204
4322004,TRIUNFO,RS,SUL,16897,10071,6826
4322103,TUCUNDUVA,RS,SUL,3941,2701,1240
4322152,TUNAS,RS,SUL,2686,996,1690
4322186,TUPANCI DO SUL,RS,SUL,1181,745,436
4322202,TUPANCIRETÃ,RS,SUL,12617,6510,6107
4322251,TUPANDI,RS,SUL,3630,2862,768
4322301,TUPARENDI,RS,SUL,5865,4291,1574
4322327,TURUÇU,RS,SUL,2648,1769,879
4322343,UBIRETAMA,RS,SUL,1603,1085,518
4322350,UNIÃO DA SERRA,RS,SUL,1267,1000,267
4322376,UNISTALDA,RS,SUL,2025,1102,923
4322400,URUGUAIANA,RS,SUL,61683,38880,22803
4322509,VACARIA,RS,SUL,36083,24745,11338
4322525,VALE VERDE,RS,SUL,2381,1200,1181
4322533,VALE DO SOL,RS,SUL,6774,3683,3091
4322541,VALE REAL,RS,SUL,3999,2651,1348
4322558,VANINI,RS,SUL,1668,1108,560
4322608,VENÂNCIO AIRES,RS,SUL,42802,27288,15514
4322707,VERA CRUZ,RS,SUL,15905,9009,6896
4322806,VERANÓPOLIS,RS,SUL,15256,12076,3180
4322855,VESPASIANO CORREA,RS,SUL,1871,1563,308
4322905,VIADUTOS,RS,SUL,3510,2375,1135
4323002,VIAMÃO,RS,SUL,123343,57395,65948
4323101,VICENTE DUTRA,RS,SUL,3046,1767,1279
4323200,VICTOR GRAEFF,RS,SUL,2076,1383,693
4323309,VILA FLORES,RS,SUL,2857,2232,625
4323358,VILA LÂNGARO,RS,SUL,1859,1353,506
4323408,VILA MARIA,RS,SUL,3020,2056,964
4323457,VILA NOVA DO SUL,RS,SUL,2871,1216,1655
4323507,VISTA ALEGRE,RS,SUL,2102,947,1155
4323606,VISTA ALEGRE DO PRATA,RS,SUL,1355,1013,342
4323705,VISTA GAÚCHA,RS,SUL,2090,1099,991
4323754,VITÓRIA DAS MISSÕES,RS,SUL,2736,1306,1430
4323770,WESTFALIA,RS,SUL,2169,1525,644
4323804,XANGRI-LÁ,RS,SUL,9758,6572,3186
5000203,ÁGUA CLARA,MS,CENTRO-OESTE,7882,4615,3267
5000252,ALCINÓPOLIS,MS,CENTRO-OESTE,2594,1274,1320
5000609,AMAMBAI,MS,CENTRO-OESTE,19208,11008,8200
5000708,ANASTÁCIO,MS,CENTRO-OESTE,12846,6944,5902
5000807,ANAURILÂNDIA,MS,CENTRO-OESTE,4405,2100,2305
5000856,ANGÉLICA,MS,CENTRO-OESTE,6260,3210,3050
5000906,ANTÔNIO JOÃO,MS,CENTRO-OESTE,5562,2971,2591
5001003,APARECIDA DO TABOADO,MS,CENTRO-OESTE,13381,8120,5261
5001102,AQUIDAUANA,MS,CENTRO-OESTE,24869,12803,12066
5001243,ARAL MOREIRA,MS,CENTRO-OESTE,5859,3232,2627
5001508,BANDEIRANTES,MS,CENTRO-OESTE,4466,2415,2051
5001904,BATAGUASSU,MS,CENTRO-OESTE,13353,7554,5799
5002001,BATAYPORÃ,MS,CENTRO-OESTE,5912,3149,2763
5002100,BELA VISTA,MS,CENTRO-OESTE,11451,6545,4906
5002159,BODOQUENA,MS,CENTRO-OESTE,4754,2473,2281
5002209,BONITO,MS,CENTRO-OESTE,13046,7855,5191
5002308,BRASILÂNDIA,MS,CENTRO-OESTE,6193,3705,2488
5002407,CAARAPÓ,MS,CENTRO-OESTE,15751,9675,6076
5002605,CAMAPUÃ,MS,CENTRO-OESTE,8160,4697,3463
5002704,CAMPO GRANDE,MS,CENTRO-OESTE,501015,313906,187109
5002803,CARACOL,MS,CENTRO-OESTE,3289,1806,1483
5002902,CASSILÂNDIA,MS,CENTRO-OESTE,10956,7122,3834
5002951,CHAPADÃO DO SUL,MS,CENTRO-OESTE,15366,10994,4372
5003108,CORGUINHO,MS,CENTRO-OESTE,2831,1489,1342
5003157,CORONEL SAPUCAIA,MS,CENTRO-OESTE,8620,4530,4090
5003207,CORUMBÁ,MS,CENTRO-OESTE,49634,25082,24552
5003256,COSTA RICA,MS,CENTRO-OESTE,15442,9506,5936
5003306,COXIM,MS,CENTRO-OESTE,18367,10152,8215
5003454,DEODÁPOLIS,MS,CENTRO-OESTE,7645,4191,3454
5003488,DOIS IRMÃOS DO BURITI,MS,CENTRO-OESTE,5985,2206,3779
5003504,DOURADINA,MS,CENTRO-OESTE,3914,2362,1552
5003702,DOURADOS,MS,CENTRO-OESTE,128926,81016,47910
5003751,ELDORADO,MS,CENTRO-OESTE,6141,3801,2340
5003801,FÁTIMA DO SUL,MS,CENTRO-OESTE,12509,6813,5696
5003900,FIGUEIRÃO,MS,CENTRO-OESTE,1848,977,871
5004007,GLÓRIA DE DOURADOS,MS,CENTRO-OESTE,5764,3091,2673
5004106,GUIA LOPES DA LAGUNA,MS,CENTRO-OESTE,5351,3008,2343
5004304,IGUATEMI,MS,CENTRO-OESTE,7456,4540,2916
5004403,INOCÊNCIA,MS,CENTRO-OESTE,4338,2529,1809
5004502,ITAPORÃ,MS,CENTRO-OESTE,10938,6974,3964
5004601,ITAQUIRAÍ,MS,CENTRO-OESTE,9695,4497,5198
5004700,IVINHEMA,MS,CENTRO-OESTE,15404,9454,5950
5004809,JAPORÃ,MS,CENTRO-OESTE,4323,1231,3092
5004908,JARAGUARI,MS,CENTRO-OESTE,3769,1934,1835
5005004,JARDIM,MS,CENTRO-OESTE,12830,8058,4772
5005103,JATEÍ,MS,CENTRO-OESTE,3216,1665,1551
5005152,JUTI,MS,CENTRO-OESTE,3955,1939,2016
5005202,LADÁRIO,MS,CENTRO-OESTE,9721,4953,4768
5005251,LAGUNA CARAPÃ,MS,CENTRO-OESTE,4239,2664,1575
5005400,MARACAJU,MS,CENTRO-OESTE,21640,14714,6926
5005608,MIRANDA,MS,CENTRO-OESTE,13429,5610,7819
5005681,MUNDO NOVO,MS,CENTRO-OESTE,10271,6445,3826
5005707,NAVIRAÍ,MS,CENTRO-OESTE,26790,17697,9093
5005806,NIOAQUE,MS,CENTRO-OESTE,7651,4073,3578
5006002,NOVA ALVORADA DO SUL,MS,CENTRO-OESTE,10697,5913,4784
5006200,NOVA ANDRADINA,MS,CENTRO-OESTE,25008,14648,10360
5006259,NOVO HORIZONTE DO SUL,MS,CENTRO-OESTE,2845,1416,1429
5006275,PARAÍSO DAS ÁGUAS,MS,CENTRO-OESTE,2859,2064,795
5006309,PARANAÍBA,MS,CENTRO-OESTE,22487,12820,9667
5006358,PARANHOS,MS,CENTRO-OESTE,5683,2388,3295
5006408,PEDRO GOMES,MS,CENTRO-OESTE,4223,2257,1966
5006606,PONTA PORÃ,MS,CENTRO-OESTE,50328,31547,18781
5006903,PORTO MURTINHO,MS,CENTRO-OESTE,5192,2741,2451
5007109,RIBAS DO RIO PARDO,MS,CENTRO-OESTE,9752,5422,4330
5007208,RIO BRILHANTE,MS,CENTRO-OESTE,18738,10973,7765
5007307,RIO NEGRO,MS,CENTRO-OESTE,2892,1552,1340
5007406,RIO VERDE DE MATO GROSSO,MS,CENTRO-OESTE,10263,5943,4320
5007505,ROCHEDO,MS,CENTRO-OESTE,3173,1787,1386
5007554,SANTA RITA DO PARDO,MS,CENTRO-OESTE,3493,1874,1619
5007695,SÃO GABRIEL DO OESTE,MS,CENTRO-OESTE,16045,11074,4971
5007703,SETE QUEDAS,MS,CENTRO-OESTE,5275,3369,1906
5007802,SELVÍRIA,MS,CENTRO-OESTE,4717,1999,2718
5007901,SIDROLÂNDIA,MS,CENTRO-OESTE,24237,13497,10740
5007935,SONORA,MS,CENTRO-OESTE,8184,4677,3507
5007950,TACURU,MS,CENTRO-OESTE,4563,1640,2923
5007976,TAQUARUSSU,MS,CENTRO-OESTE,2714,1253,1461
5008008,TERENOS,MS,CENTRO-OESTE,9737,5081,4656
5008305,TRÊS LAGOAS,MS,CENTRO-OESTE,63363,37415,25948
5008404,VICENTINA,MS,CENTRO-OESTE,4465,1882,2583
5100102,ACORIZAL,MT,CENTRO-OESTE,5193,2355,2838
5100201,ÁGUA BOA,MT,CENTRO-OESTE,14441,11324,3117
5100250,ALTA FLORESTA,MT,CENTRO-OESTE,31295,22236,9059
5100300,ALTO ARAGUAIA,MT,CENTRO-OESTE,8758,5513,3245
5100359,ALTO BOA VISTA,MT,CENTRO-OESTE,2892,2175,717
5100409,ALTO GARÇAS,MT,CENTRO-OESTE,6159,3802,2357
5100508,ALTO PARAGUAI,MT,CENTRO-OESTE,4464,1817,2647
5100607,ALTO TAQUARI,MT,CENTRO-OESTE,5328,3551,1777
5100805,APIACÁS,MT,CENTRO-OESTE,4200,2700,1500
5101001,ARAGUAIANA,MT,CENTRO-OESTE,2285,1192,1093
5101209,ARAGUAINHA,MT,CENTRO-OESTE,781,365,416
5101258,ARAPUTANGA,MT,CENTRO-OESTE,8734,6249,2485
5101308,ARENÁPOLIS,MT,CENTRO-OESTE,5878,3465,2413
5101407,ARIPUANÃ,MT,CENTRO-OESTE,9473,7103,2370
5101605,BARÃO DE MELGAÇO,MT,CENTRO-OESTE,4618,1701,2917
5101704,BARRA DO BUGRES,MT,CENTRO-OESTE,17533,8888,8645
5101803,BARRA DO GARÇAS,MT,CENTRO-OESTE,34162,20791,13371
5101852,BOM JESUS DO ARAGUAIA,MT,CENTRO-OESTE,3370,2098,1272
5101902,BRASNORTE,MT,CENTRO-OESTE,8321,6035,2286
5102504,CÁCERES,MT,CENTRO-OESTE,46903,24217,22686
5102603,CAMPINÁPOLIS,MT,CENTRO-OESTE,7381,3207,4174
5102637,CAMPO NOVO DO PARECIS,MT,CENTRO-OESTE,20204,13944,6260
5102678,CAMPO VERDE,MT,CENTRO-OESTE,23778,16427,7351
5102686,CAMPOS DE JÚLIO,MT,CENTRO-OESTE,3892,2833,1059
5102694,CANABRAVA DO NORTE,MT,CENTRO-OESTE,2582,1764,818
5102702,CANARANA,MT,CENTRO-OESTE,11980,9318,2662
5102793,CARLINDA,MT,CENTRO-OESTE,5769,3357,2412
5102850,CASTANHEIRA,MT,CENTRO-OESTE,4171,2812,1359
5103007,CHAPADA DOS GUIMARÃES,MT,CENTRO-OESTE,12412,6233,6179
5103056,CLÁUDIA,MT,CENTRO-OESTE,6310,4753,1557
5103106,COCALINHO,MT,CENTRO-OESTE,3157,1816,1341
5103205,COLÍDER,MT,CENTRO-OESTE,18118,14589,3529
5103254,COLNIZA,MT,CENTRO-OESTE,12466,9420,3046
5103304,COMODORO,MT,CENTRO-OESTE,9930,6810,3120
5103353,CONFRESA,MT,CENTRO-OESTE,15937,11129,4808
5103361,CONQUISTA D'OESTE,MT,CENTRO-OESTE,2149,1568,581
5103379,COTRIGUAÇU,MT,CENTRO-OESTE,6161,4330,1831
5103403,CUIABÁ,MT,CENTRO-OESTE,347639,213787,133852
5103437,CURVELÂNDIA,MT,CENTRO-OESTE,3292,2073,1219
5103452,DENISE,MT,CENTRO-OESTE,4405,2419,1986
5103502,DIAMANTINO,MT,CENTRO-OESTE,12399,7804,4595
5103601,DOM AQUINO,MT,CENTRO-OESTE,4731,2721,2010
5103700,FELIZ NATAL,MT,CENTRO-OESTE,4618,3133,1485
5103809,FIGUEIRÓPOLIS D'OESTE,MT,CENTRO-OESTE,2184,1645,539
5103858,GAÚCHA DO NORTE,MT,CENTRO-OESTE,4025,2757,1268
5103908,GENERAL CARNEIRO,MT,CENTRO-OESTE,3027,1526,1501
5103957,GLÓRIA D'OESTE,MT,CENTRO-OESTE,2008,1354,654
5104104,GUARANTÃ DO NORTE,MT,CENTRO-OESTE,16712,13560,3152
5104203,GUIRATINGA,MT,CENTRO-OESTE,6246,3386,2860
5104500,INDIAVAÍ,MT,CENTRO-OESTE,1449,829,620
5104526,IPIRANGA DO NORTE,MT,CENTRO-OESTE,3764,2796,968
5104542,ITANHANGÁ,MT,CENTRO-OESTE,3940,3185,755
5104559,ITAÚBA,MT,CENTRO-OESTE,2985,2057,928
5104609,ITIQUIRA,MT,CENTRO-OESTE,6472,3954,2518
5104807,JACIARA,MT,CENTRO-OESTE,15478,10513,4965
5104906,JANGADA,MT,CENTRO-OESTE,5106,2115,2991
5105002,JAURU,MT,CENTRO-OESTE,5007,3566,1441
5105101,JUARA,MT,CENTRO-OESTE,18018,13708,4310
5105150,JUÍNA,MT,CENTRO-OESTE,24153,16995,7158
5105176,JURUENA,MT,CENTRO-OESTE,4519,3250,1269
5105200,JUSCIMEIRA,MT,CENTRO-OESTE,6806,3958,2848
5105234,LAMBARI D'OESTE,MT,CENTRO-OESTE,3029,1574,1455
5105259,LUCAS DO RIO VERDE,MT,CENTRO-OESTE,37296,27919,9377
5105309,LUCIARA,MT,CENTRO-OESTE,1611,881,730
5105507,VILA BELA DA SANTÍSSIMA TRINDADE,MT,CENTRO-OESTE,7297,4157,3140
5105580,MARCELÂNDIA,MT,CENTRO-OESTE,6383,4931,1452
5105606,MATUPÁ,MT,CENTRO-OESTE,9826,7288,2538
5105622,MIRASSOL D'OESTE,MT,CENTRO-OESTE,14625,10080,4545
5105903,NOBRES,MT,CENTRO-OESTE,8960,6154,2806
5106000,NORTELÂNDIA,MT,CENTRO-OESTE,3573,1774,1799
5106109,NOSSA SENHORA DO LIVRAMENTO,MT,CENTRO-OESTE,9341,3081,6260
5106158,NOVA BANDEIRANTES,MT,CENTRO-OESTE,6573,5272,1301
5106174,NOVA NAZARÉ,MT,CENTRO-OESTE,1845,994,851
5106182,NOVA LACERDA,MT,CENTRO-OESTE,3043,1906,1137
5106190,NOVA SANTA HELENA,MT,CENTRO-OESTE,2196,1588,608
5106208,NOVA BRASILÂNDIA,MT,CENTRO-OESTE,2692,1313,1379
5106216,NOVA CANAÃ DO NORTE,MT,CENTRO-OESTE,7192,5281,1911
5106224,NOVA MUTUM,MT,CENTRO-OESTE,24970,18643,6327
5106232,NOVA OLÍMPIA,MT,CENTRO-OESTE,9251,4456,4795
5106240,NOVA UBIRATÃ,MT,CENTRO-OESTE,5563,3875,1688
5106257,NOVA XAVANTINA,MT,CENTRO-OESTE,11592,8011,3581
5106265,NOVO MUNDO,MT,CENTRO-OESTE,3834,2723,1111
5106273,NOVO HORIZONTE DO NORTE,MT,CENTRO-OESTE,2370,1603,767
5106281,NOVO SÃO JOAQUIM,MT,CENTRO-OESTE,3899,2658,1241
5106299,PARANAÍTA,MT,CENTRO-OESTE,7009,4903,2106
5106307,PARANATINGA,MT,CENTRO-OESTE,11145,7801,3344
5106315,NOVO SANTO ANTÔNIO,MT,CENTRO-OESTE,1224,743,481
5106372,PEDRA PRETA,MT,CENTRO-OESTE,10616,5963,4653
5106422,PEIXOTO DE AZEVEDO,MT,CENTRO-OESTE,16734,9632,7102
5106455,PLANALTO DA SERRA,MT,CENTRO-OESTE,1969,976,993
5106505,POCONÉ,MT,CENTRO-OESTE,17904,6510,11394
5106653,PONTAL DO ARAGUAIA,MT,CENTRO-OESTE,3741,2187,1554
5106703,PONTE BRANCA,MT,CENTRO-OESTE,1384,558,826
5106752,PONTES E LACERDA,MT,CENTRO-OESTE,23257,17559,5698
5106778,PORTO ALEGRE DO NORTE,MT,CENTRO-OESTE,5594,3418,2176
5106802,PORTO DOS GAÚCHOS,MT,CENTRO-OESTE,3037,2263,774
5106828,PORTO ESPERIDIÃO,MT,CENTRO-OESTE,5364,2975,2389
5106851,PORTO ESTRELA,MT,CENTRO-OESTE,2292,817,1475
5107008,POXORÉO,MT,CENTRO-OESTE,9770,5066,4704
5107040,PRIMAVERA DO LESTE,MT,CENTRO-OESTE,38945,29462,9483
5107065,QUERÊNCIA,MT,CENTRO-OESTE,10567,7944,2623
5107107,SÃO JOSÉ DOS QUATRO MARCOS,MT,CENTRO-OESTE,10247,7048,3199
5107156,RESERVA DO CABAÇAL,MT,CENTRO-OESTE,1332,765,567
5107180,RIBEIRÃO CASCALHEIRA,MT,CENTRO-OESTE,5040,3373,1667
5107198,RIBEIRÃOZINHO,MT,CENTRO-OESTE,1622,847,775
5107206,RIO BRANCO,MT,CENTRO-OESTE,2918,1670,1248
5107248,SANTA CARMEM,MT,CENTRO-OESTE,2909,2251,658
5107263,SANTO AFONSO,MT,CENTRO-OESTE,1679,990,689
5107297,SÃO JOSÉ DO POVO,MT,CENTRO-OESTE,2048,1132,916
5107305,SÃO JOSÉ DO RIO CLARO,MT,CENTRO-OESTE,8504,6530,1974
5107354,SÃO JOSÉ DO XINGU,MT,CENTRO-OESTE,2863,1653,1210
5107404,SÃO PEDRO DA CIPA,MT,CENTRO-OESTE,2674,1426,1248
5107578,RONDOLÂNDIA,MT,CENTRO-OESTE,1848,1029,819
5107602,RONDONÓPOLIS,MT,CENTRO-OESTE,127564,82752,44812
5107701,ROSÁRIO OESTE,MT,CENTRO-OESTE,9258,4467,4791
5107743,SANTA CRUZ DO XINGU,MT,CENTRO-OESTE,1295,891,404
5107750,SALTO DO CÉU,MT,CENTRO-OESTE,2244,1476,768
5107768,SANTA RITA DO TRIVELATO,MT,CENTRO-OESTE,1615,1104,511
5107776,SANTA TEREZINHA,BA,NORDESTE,6494,1212,5282
5107792,SANTO ANTÔNIO DO LESTE,MT,CENTRO-OESTE,1782,1128,654
5107800,SANTO ANTÔNIO DO LEVERGER,MT,CENTRO-OESTE,12481,5830,6651
5107859,SÃO FÉLIX DO ARAGUAIA,MT,CENTRO-OESTE,5078,3097,1981
5107875,SAPEZAL,MT,CENTRO-OESTE,13416,9354,4062
5107883,SERRA NOVA DOURADA,MT,CENTRO-OESTE,1107,747,360
5107909,SINOP,MT,CENTRO-OESTE,84756,65216,19540
5107925,SORRISO,MT,CENTRO-OESTE,52944,39360,13584
5107941,TABAPORÃ,MT,CENTRO-OESTE,5048,3881,1167
5107958,TANGARÁ DA SERRA,MT,CENTRO-OESTE,53111,38964,14147
5108006,TAPURAH,MT,CENTRO-OESTE,6727,5188,1539
5108055,TERRA NOVA DO NORTE,MT,CENTRO-OESTE,6357,4199,2158
5108105,TESOURO,MT,CENTRO-OESTE,1933,931,1002
5108204,TORIXORÉU,MT,CENTRO-OESTE,2614,1383,1231
5108303,UNIÃO DO SUL,MT,CENTRO-OESTE,2262,1567,695
5108352,VALE DE SÃO DOMINGOS,MT,CENTRO-OESTE,1910,1438,472
5108402,VÁRZEA GRANDE,MT,CENTRO-OESTE,143695,84427,59268
5108501,VERA,MT,CENTRO-OESTE,5342,3847,1495
5108600,VILA RICA,MT,CENTRO-OESTE,9898,6914,2984
5108808,NOVA GUARITA,MT,CENTRO-OESTE,2932,1892,1040
5108857,NOVA MARILÂNDIA,MT,CENTRO-OESTE,1963,1190,773
5108907,NOVA MARINGÁ,MT,CENTRO-OESTE,3017,2149,868
5108956,NOVA MONTE VERDE,MT,CENTRO-OESTE,4480,3227,1253
5200050,ABADIA DE GOIÁS,GO,CENTRO-OESTE,9208,5394,3814
5200100,ABADIÂNIA,GO,CENTRO-OESTE,8533,5759,2774
5200134,ACREÚNA,GO,CENTRO-OESTE,11807,6597,5210
5200159,ADELÂNDIA,GO,CENTRO-OESTE,2168,1517,651
5200175,ÁGUA FRIA DE GOIÁS,GO,CENTRO-OESTE,3431,2051,1380
5200209,ÁGUA LIMPA,GO,CENTRO-OESTE,1741,954,787
5200258,ÁGUAS LINDAS DE GOIÁS,GO,CENTRO-OESTE,85315,44946,40369
5200308,ALEXÂNIA,GO,CENTRO-OESTE,15844,10643,5201
5200506,ALOÂNDIA,GO,CENTRO-OESTE,1612,864,748
5200555,ALTO HORIZONTE,GO,CENTRO-OESTE,4365,2540,1825
5200605,ALTO PARAÍSO DE GOIÁS,GO,CENTRO-OESTE,5143,1955,3188
5200803,ALVORADA DO NORTE,GO,CENTRO-OESTE,4774,2280,2494
5200829,AMARALINA,GO,CENTRO-OESTE,2309,994,1315
5200852,AMERICANO DO BRASIL,GO,CENTRO-OESTE,4063,2020,2043
5200902,AMORINÓPOLIS,GO,CENTRO-OESTE,2888,1588,1300
5201108,ANÁPOLIS,GO,CENTRO-OESTE,217467,153507,63960
5201207,ANHANGUERA,GO,CENTRO-OESTE,854,396,458
5201306,ANICUNS,GO,CENTRO-OESTE,11905,7237,4668
5201405,APARECIDA DE GOIÂNIA,GO,CENTRO-OESTE,256815,148793,108022
5201454,APARECIDA DO RIO DOCE,GO,CENTRO-OESTE,2168,1091,1077
5201504,APORÉ,GO,CENTRO-OESTE,2237,1251,986
5201603,ARAÇU,GO,CENTRO-OESTE,3191,1603,1588
5201702,ARAGARÇAS,GO,CENTRO-OESTE,10299,5795,4504
5201801,ARAGOIÂNIA,GO,CENTRO-OESTE,6746,3749,2997
5202155,ARAGUAPAZ,GO,CENTRO-OESTE,4401,2318,2083
5202353,ARENÓPOLIS,GO,CENTRO-OESTE,2524,1291,1233
5202502,ARUANÃ,GO,CENTRO-OESTE,4629,2417,2212
5202601,AURILÂNDIA,GO,CENTRO-OESTE,2441,1104,1337
5202809,AVELINÓPOLIS,GO,CENTRO-OESTE,2638,1589,1049
5203104,BALIZA,GO,CENTRO-OESTE,2013,813,1200
5203203,BARRO ALTO,GO,CENTRO-OESTE,7104,3833,3271
5203302,BELA VISTA DE GOIÁS,GO,CENTRO-OESTE,17356,10182,7174
5203401,BOM JARDIM DE GOIÁS,GO,CENTRO-OESTE,5336,2484,2852
5203500,BOM JESUS DE GOIÁS,GO,CENTRO-OESTE,12788,6789,5999
5203559,BONFINÓPOLIS,GO,CENTRO-OESTE,5328,2720,2608
5203575,BONÓPOLIS,GO,CENTRO-OESTE,2347,1030,1317
5203609,BRAZABRANTES,GO,CENTRO-OESTE,2661,1499,1162
5203807,BRITÂNIA,GO,CENTRO-OESTE,3578,2098,1480
5203906,BURITI ALEGRE,GO,CENTRO-OESTE,5980,3200,2780
5203939,BURITI DE GOIÁS,GO,CENTRO-OESTE,2510,1654,856
5203962,BURITINÓPOLIS,GO,CENTRO-OESTE,2342,1036,1306
5204003,CABECEIRAS,GO,CENTRO-OESTE,5187,2526,2661
5204102,CACHOEIRA ALTA,GO,CENTRO-OESTE,5929,3125,2804
5204201,CACHOEIRA DE GOIÁS,GO,CENTRO-OESTE,1348,704,644
5204250,CACHOEIRA DOURADA,GO,CENTRO-OESTE,5383,2474,2909
5204300,CAÇU,GO,CENTRO-OESTE,8143,5110,3033
5204409,CAIAPÔNIA,GO,CENTRO-OESTE,9876,5738,4138
5204508,CALDAS NOVAS,GO,CENTRO-OESTE,47954,30802,17152
5204557,CALDAZINHA,GO,CENTRO-OESTE,2532,1366,1166
5204607,CAMPESTRE DE GOIÁS,GO,CENTRO-OESTE,2792,1457,1335
5204656,CAMPINAÇU,GO,CENTRO-OESTE,2591,1257,1334
5204706,CAMPINORTE,GO,CENTRO-OESTE,6716,4287,2429
5204805,CAMPO ALEGRE DE GOIÁS,GO,CENTRO-OESTE,4110,2050,2060
5204854,CAMPO LIMPO DE GOIÁS,GO,CENTRO-OESTE,4701,3013,1688
5204904,CAMPOS BELOS,GO,CENTRO-OESTE,10440,3988,6452
5204953,CAMPOS VERDES,GO,CENTRO-OESTE,2888,961,1927
5205000,CARMO DO RIO VERDE,GO,CENTRO-OESTE,5541,3290,2251
5205059,CASTELÂNDIA,GO,CENTRO-OESTE,2751,1302,1449
5205109,CATALÃO,GO,CENTRO-OESTE,57487,28789,28698
5205208,CATURAÍ,GO,CENTRO-OESTE,3654,1672,1982
5205307,CAVALCANTE,GO,CENTRO-OESTE,5072,884,4188
5205406,CERES,GO,CENTRO-OESTE,13333,8627,4706
5205455,CEZARINA,GO,CENTRO-OESTE,5476,3120,2356
5205471,CHAPADÃO DO CÉU,GO,CENTRO-OESTE,6396,4329,2067
5205497,CIDADE OCIDENTAL,GO,CENTRO-OESTE,34678,18679,15999
5205513,COCALZINHO DE GOIÁS,GO,CENTRO-OESTE,11852,7083,4769
5205521,COLINAS DO SUL,GO,CENTRO-OESTE,2314,761,1553
5205703,CÓRREGO DO OURO,GO,CENTRO-OESTE,2333,1644,689
5205802,CORUMBÁ DE GOIÁS,GO,CENTRO-OESTE,5547,3242,2305
5205901,CORUMBAÍBA,GO,CENTRO-OESTE,5241,2924,2317
5206206,CRISTALINA,GO,CENTRO-OESTE,26561,17318,9243
5206305,CRISTIANÓPOLIS,GO,CENTRO-OESTE,2954,1939,1015
5206404,CRIXÁS,GO,CENTRO-OESTE,9102,4050,5052
5206503,CROMÍNIA,GO,CENTRO-OESTE,2985,1657,1328
5206602,CUMARI,GO,CENTRO-OESTE,1990,785,1205
5206701,DAMIANÓPOLIS,GO,CENTRO-OESTE,2644,1358,1286
5206800,DAMOLÂNDIA,GO,CENTRO-OESTE,2686,1410,1276
5206909,DAVINÓPOLIS,GO,CENTRO-OESTE,2586,1005,1581
5207105,DIORAMA,GO,CENTRO-OESTE,1824,1095,729
5207253,DOVERLÂNDIA,GO,CENTRO-OESTE,4422,2368,2054
5207352,EDEALINA,GO,CENTRO-OESTE,3065,1857,1208
5207402,EDÉIA,GO,CENTRO-OESTE,7353,4242,3111
5207501,ESTRELA DO NORTE,GO,CENTRO-OESTE,2279,1117,1162
5207535,FAINA,GO,CENTRO-OESTE,4579,1973,2606
5207600,FAZENDA NOVA,GO,CENTRO-OESTE,4177,2347,1830
5207808,FIRMINÓPOLIS,GO,CENTRO-OESTE,6557,4356,2201
5207907,FLORES DE GOIÁS,GO,CENTRO-OESTE,4919,2236,2683
5208004,FORMOSA,GO,CENTRO-OESTE,58112,33414,24698
5208103,FORMOSO,GO,CENTRO-OESTE,3406,1607,1799
5208152,GAMELEIRA DE GOIÁS,GO,CENTRO-OESTE,2553,1396,1157
5208301,DIVINÓPOLIS DE GOIÁS,GO,CENTRO-OESTE,3358,1143,2215
5208400,GOIANÁPOLIS,GO,CENTRO-OESTE,7988,5779,2209
5208509,GOIANDIRA,GO,CENTRO-OESTE,3487,1543,1944
5208608,GOIANÉSIA,GO,CENTRO-OESTE,43503,25164,18339
5208707,GOIÂNIA,GO,CENTRO-OESTE,802190,513018,289172
5208806,GOIANIRA,GO,CENTRO-OESTE,30342,16788,13554
5208905,GOIÁS,GO,CENTRO-OESTE,14547,6307,8240
5209101,GOIATUBA,GO,CENTRO-OESTE,20899,13024,7875
5209150,GOUVELÂNDIA,GO,CENTRO-OESTE,2862,1145,1717
5209200,GUAPÓ,GO,CENTRO-OESTE,10186,5169,5017
5209291,GUARAÍTA,GO,CENTRO-OESTE,2135,1101,1034
5209408,GUARANI DE GOIÁS,GO,CENTRO-OESTE,3243,1038,2205
5209457,GUARINOS,GO,CENTRO-OESTE,1735,634,1101
5209606,HEITORAÍ,GO,CENTRO-OESTE,3029,1608,1421
5209705,HIDROLÂNDIA,GO,CENTRO-OESTE,14206,7959,6247
5209804,HIDROLINA,GO,CENTRO-OESTE,2873,1329,1544
5209903,IACIARA,GO,CENTRO-OESTE,5775,2362,3413
5209937,INACIOLÂNDIA,GO,CENTRO-OESTE,3541,1444,2097
5209952,INDIARA,GO,CENTRO-OESTE,8911,4541,4370
5210000,INHUMAS,GO,CENTRO-OESTE,31146,17182,13964
5210109,IPAMERI,GO,CENTRO-OESTE,15357,8329,7028
5210158,IPIRANGA DE GOIÁS,GO,CENTRO-OESTE,2376,1368,1008
5210208,IPORÁ,GO,CENTRO-OESTE,19756,11960,7796
5210307,ISRAELÂNDIA,GO,CENTRO-OESTE,2107,1091,1016
5210406,ITABERAÍ,GO,CENTRO-OESTE,24294,12965,11329
5210562,ITAGUARI,GO,CENTRO-OESTE,3871,1852,2019
5210604,ITAGUARU,GO,CENTRO-OESTE,4281,1993,2288
5210802,ITAJÁ,GO,CENTRO-OESTE,2769,1678,1091
5210901,ITAPACI,GO,CENTRO-OESTE,11588,5864,5724
5211008,ITAPIRAPUÃ,GO,CENTRO-OESTE,5096,2453,2643
5211206,ITAPURANGA,GO,CENTRO-OESTE,17263,9129,8134
5211305,ITARUMÃ,GO,CENTRO-OESTE,3243,1718,1525
5211404,ITAUÇU,GO,CENTRO-OESTE,5756,3123,2633
5211503,ITUMBIARA,GO,CENTRO-OESTE,56718,33470,23248
5211602,IVOLÂNDIA,GO,CENTRO-OESTE,2098,1060,1038
5211701,JANDAIA,GO,CENTRO-OESTE,4611,2704,1907
5211800,JARAGUÁ,GO,CENTRO-OESTE,25450,17449,8001
5211909,JATAÍ,GO,CENTRO-OESTE,54272,34099,20173
5212006,JAUPACI,GO,CENTRO-OESTE,2037,976,1061
5212055,JESÚPOLIS,GO,CENTRO-OESTE,1872,1153,719
5212105,JOVIÂNIA,GO,CENTRO-OESTE,4333,2287,2046
5212204,JUSSARA,GO,CENTRO-OESTE,10994,4433,6561
5212253,LAGOA SANTA,GO,CENTRO-OESTE,1103,665,438
5212303,LEOPOLDO DE BULHÕES,GO,CENTRO-OESTE,5082,2738,2344
5212501,LUZIÂNIA,GO,CENTRO-OESTE,98942,59686,39256
5212600,MAIRIPOTABA,GO,CENTRO-OESTE,2036,1151,885
5212709,MAMBAÍ,GO,CENTRO-OESTE,4515,2720,1795
5212808,MARA ROSA,GO,CENTRO-OESTE,6192,3279,2913
5212907,MARZAGÃO,GO,CENTRO-OESTE,1934,989,945
5212956,MATRINCHÃ,GO,CENTRO-OESTE,2866,1395,1471
5213004,MAURILÂNDIA,GO,CENTRO-OESTE,5329,2460,2869
5213053,MIMOSO DE GOIÁS,GO,CENTRO-OESTE,2320,1138,1182
5213087,MINAÇU,GO,CENTRO-OESTE,16300,8788,7512
5213103,MINEIROS,GO,CENTRO-OESTE,35585,20936,14649
5213400,MOIPORÁ,GO,CENTRO-OESTE,1720,1073,647
5213509,MONTE ALEGRE DE GOIÁS,GO,CENTRO-OESTE,3848,1189,2659
5213707,MONTES CLAROS DE GOIÁS,GO,CENTRO-OESTE,5154,3057,2097
5213756,MONTIVIDIU,GO,CENTRO-OESTE,7487,5010,2477
5213772,MONTIVIDIU DO NORTE,GO,CENTRO-OESTE,2542,1286,1256
5213806,MORRINHOS,GO,CENTRO-OESTE,27415,15783,11632
5213855,MORRO AGUDO DE GOIÁS,GO,CENTRO-OESTE,2270,1392,878
5213905,MOSSÂMEDES,GO,CENTRO-OESTE,3581,1454,2127
5214002,MOZARLÂNDIA,GO,CENTRO-OESTE,8619,4704,3915
5214051,MUNDO NOVO,GO,CENTRO-OESTE,3635,1797,1838
5214101,MUTUNÓPOLIS,GO,CENTRO-OESTE,2634,1506,1128
5214408,NAZÁRIO,GO,CENTRO-OESTE,5604,3323,2281
5214507,NERÓPOLIS,GO,CENTRO-OESTE,17779,9957,7822
5214606,NIQUELÂNDIA,GO,CENTRO-OESTE,19924,10636,9288
5214705,NOVA AMÉRICA,GO,CENTRO-OESTE,1943,1090,853
5214804,NOVA AURORA,GO,CENTRO-OESTE,1748,774,974
5214838,NOVA CRIXÁS,GO,CENTRO-OESTE,6344,2933,3411
5214861,NOVA GLÓRIA,GO,CENTRO-OESTE,5261,2839,2422
5214879,NOVA IGUAÇU DE GOIÁS,GO,CENTRO-OESTE,2026,1049,977
5214903,NOVA ROMA,GO,CENTRO-OESTE,1960,557,1403
5215009,NOVA VENEZA,GO,CENTRO-OESTE,6221,3552,2669
5215207,NOVO BRASIL,GO,CENTRO-OESTE,2569,1443,1126
5215231,NOVO GAMA,GO,CENTRO-OESTE,39536,21719,17817
5215256,NOVO PLANALTO,GO,CENTRO-OESTE,2683,1426,1257
5215306,ORIZONA,GO,CENTRO-OESTE,9200,5321,3879
5215405,OURO VERDE DE GOIÁS,GO,CENTRO-OESTE,2912,1728,1184
5215504,OUVIDOR,GO,CENTRO-OESTE,6846,3163,3683
5215603,PADRE BERNARDO,GO,CENTRO-OESTE,14234,7905,6329
5215652,PALESTINA DE GOIÁS,GO,CENTRO-OESTE,2737,1613,1124
5215702,PALMEIRAS DE GOIÁS,GO,CENTRO-OESTE,16581,10469,6112
5215801,PALMELO,GO,CENTRO-OESTE,1720,925,795
5215900,PALMINÓPOLIS,GO,CENTRO-OESTE,3215,2136,1079
5216007,PANAMÁ,GO,CENTRO-OESTE,1942,959,983
5216304,PARANAIGUARA,GO,CENTRO-OESTE,5279,2366,2913
5216403,PARAÚNA,GO,CENTRO-OESTE,6669,3988,2681
5216452,PEROLÂNDIA,GO,CENTRO-OESTE,2305,1277,1028
5216809,PETROLINA DE GOIÁS,GO,CENTRO-OESTE,5573,3377,2196
5216908,PILAR DE GOIÁS,GO,CENTRO-OESTE,2618,1159,1459
5217104,PIRACANJUBA,GO,CENTRO-OESTE,14026,7634,6392
5217203,PIRANHAS,GO,CENTRO-OESTE,7216,3985,3231
5217302,PIRENÓPOLIS,GO,CENTRO-OESTE,15393,8523,6870
5217401,PIRES DO RIO,GO,CENTRO-OESTE,16315,10397,5918
5217609,PLANALTINA,GO,CENTRO-OESTE,46997,24240,22757
5217708,PONTALINA,GO,CENTRO-OESTE,11051,6080,4971
5218003,PORANGATU,GO,CENTRO-OESTE,23298,12830,10468
5218052,PORTEIRÃO,GO,CENTRO-OESTE,2612,1345,1267
5218102,PORTELÂNDIA,GO,CENTRO-OESTE,2407,1292,1115
5218300,POSSE,GO,CENTRO-OESTE,18722,9144,9578
5218391,PROFESSOR JAMIL,GO,CENTRO-OESTE,2342,1107,1235
5218508,QUIRINÓPOLIS,GO,CENTRO-OESTE,26771,14276,12495
5218607,RIALMA,GO,CENTRO-OESTE,6947,4566,2381
5218706,RIANÁPOLIS,GO,CENTRO-OESTE,2940,1926,1014
5218789,RIO QUENTE,GO,CENTRO-OESTE,2845,1707,1138
5218805,RIO VERDE,GO,CENTRO-OESTE,112100,69385,42715
5218904,RUBIATABA,GO,CENTRO-OESTE,11727,7887,3840
5219001,SANCLERLÂNDIA,GO,CENTRO-OESTE,5498,3080,2418
5219100,SANTA BÁRBARA DE GOIÁS,GO,CENTRO-OESTE,4151,2356,1795
5219209,SANTA CRUZ DE GOIÁS,GO,CENTRO-OESTE,2384,1277,1107
5219258,SANTA FÉ DE GOIÁS,GO,CENTRO-OESTE,2991,1597,1394
5219308,SANTA HELENA DE GOIÁS,GO,CENTRO-OESTE,23125,12407,10718
5219357,SANTA ISABEL,GO,CENTRO-OESTE,2850,1681,1169
5219407,SANTA RITA DO ARAGUAIA,GO,CENTRO-OESTE,3190,1739,1451
5219456,SANTA RITA DO NOVO DESTINO,GO,CENTRO-OESTE,2184,1059,1125
5219506,SANTA ROSA DE GOIÁS,GO,CENTRO-OESTE,2528,1289,1239
5219605,SANTA TEREZA DE GOIÁS,GO,CENTRO-OESTE,2315,1079,1236
5219704,SANTA TEREZINHA DE GOIÁS,GO,CENTRO-OESTE,5779,2650,3129
5219712,SANTO ANTÔNIO DA BARRA,GO,CENTRO-OESTE,3148,1381,1767
5219738,SANTO ANTÔNIO DE GOIÁS,GO,CENTRO-OESTE,4777,2609,2168
5219753,SANTO ANTÔNIO DO DESCOBERTO,GO,CENTRO-OESTE,33111,18879,14232
5219803,SÃO DOMINGOS,GO,CENTRO-OESTE,4990,1699,3291
5219902,SÃO FRANCISCO DE GOIÁS,GO,CENTRO-OESTE,3659,2211,1448
5220009,SÃO JOÃO D'ALIANÇA,GO,CENTRO-OESTE,5305,2600,2705
5220058,SÃO JOÃO DA PARAÚNA,GO,CENTRO-OESTE,1674,1006,668
5220108,SÃO LUÍS DE MONTES BELOS,GO,CENTRO-OESTE,18767,13526,5241
5220157,SÃO LUÍZ DO NORTE,GO,CENTRO-OESTE,3511,1595,1916
5220207,SÃO MIGUEL DO ARAGUAIA,GO,CENTRO-OESTE,13389,8200,5189
5220264,SÃO MIGUEL DO PASSA QUATRO,GO,CENTRO-OESTE,2816,1469,1347
5220280,SÃO PATRÍCIO,GO,CENTRO-OESTE,1846,1184,662
5220405,SÃO SIMÃO,GO,CENTRO-OESTE,10164,4542,5622
5220454,SENADOR CANEDO,GO,CENTRO-OESTE,64551,35464,29087
5220504,SERRANÓPOLIS,GO,CENTRO-OESTE,4676,2414,2262
5220603,SILVÂNIA,GO,CENTRO-OESTE,12384,7309,5075
5220686,SIMOLÂNDIA,GO,CENTRO-OESTE,4059,1705,2354
5220702,SÍTIO D'ABADIA,GO,CENTRO-OESTE,1991,828,1163
5221007,TAQUARAL DE GOIÁS,GO,CENTRO-OESTE,3389,1924,1465
5221080,TERESINA DE GOIÁS,GO,CENTRO-OESTE,1859,623,1236
5221197,TEREZÓPOLIS DE GOIÁS,GO,CENTRO-OESTE,4928,2729,2199
5221304,TRÊS RANCHOS,GO,CENTRO-OESTE,2735,1194,1541
5221403,TRINDADE,GO,CENTRO-OESTE,68734,39215,29519
5221452,TROMBAS,GO,CENTRO-OESTE,2130,1082,1048
5221502,TURVÂNIA,GO,CENTRO-OESTE,3656,2294,1362
5221551,TURVELÂNDIA,GO,CENTRO-OESTE,3128,1344,1784
5221577,UIRAPURU,GO,CENTRO-OESTE,1965,867,1098
5221601,URUAÇU,GO,CENTRO-OESTE,21933,12139,9794
5221700,URUANA,GO,CENTRO-OESTE,8174,4668,3506
5221809,URUTAÍ,GO,CENTRO-OESTE,2568,1256,1312
5221858,VALPARAÍSO DE GOIÁS,GO,CENTRO-OESTE,70999,39822,31177
5221908,VARJÃO,GO,CENTRO-OESTE,2892,1804,1088
5222005,VIANÓPOLIS,GO,CENTRO-OESTE,8515,5618,2897
5222054,VICENTINÓPOLIS,GO,CENTRO-OESTE,5019,2613,2406
5222203,VILA BOA,GO,CENTRO-OESTE,2656,935,1721
5222302,VILA PROPÍCIO,GO,CENTRO-OESTE,3840,1959,1881
5300108,BRASÍLIA,DF,CENTRO-OESTE,1770626,1041331,729295